AAAAAACCATCTGAGGATG -> AAAAACCATCTGAGGATGC
AAAAAAGCCCATACGGGCA -> AAAAAGCCCATACGGGCAC
AAAAAAGTTTATCTGTGAG -> AAAAAGTTTATCTGTGAGT
AAAAACCATCTGAGGATGC -> AAAACCATCTGAGGATGCG
AAAAACGTTTGAGGCTGTA -> AAAACGTTTGAGGCTGTAC
AAAAAGCCCATACGGGCAC -> AAAAGCCCATACGGGCACT
AAAAAGCTGGGCCTAACGA -> AAAAGCTGGGCCTAACGAC
AAAAAGTTTATCTGTGAGT -> AAAAGTTTATCTGTGAGTT
AAAACCATCTGAGGATGCG -> AAACCATCTGAGGATGCGA
AAAACGTTTGAGGCTGTAC -> AAACGTTTGAGGCTGTACT
AAAAGCCCATACGGGCACT -> AAAGCCCATACGGGCACTG
AAAAGCTGGGCCTAACGAC -> AAAGCTGGGCCTAACGACC
AAAAGGCGGTCGGACCCTC -> AAAGGCGGTCGGACCCTCG
AAAAGTTTATCTGTGAGTT -> AAAGTTTATCTGTGAGTTA
AAAATAATAACATATATGA -> AAATAATAACATATATGAA
AAACAAATTTGGCGAGTTG -> AACAAATTTGGCGAGTTGA
AAACATCAGGAACCAGTCC -> AACATCAGGAACCAGTCCA
AAACATGTGATGTTTCTTT -> AACATGTGATGTTTCTTTA
AAACCATCTGAGGATGCGA -> AACCATCTGAGGATGCGAC
AAACCGGCGTTGAACAACG -> AACCGGCGTTGAACAACGA
AAACCTGGGACACGAGTAT -> AACCTGGGACACGAGTATG
AAACGCGTATGTCACACTA -> AACGCGTATGTCACACTAT
AAACGTTTGAGGCTGTACT -> AACGTTTGAGGCTGTACTG
AAACTCATCGTAGGCACTT -> AACTCATCGTAGGCACTTG
AAACTCCGGTTTTTTGCCC -> AACTCCGGTTTTTTGCCCT
AAACTTCAGCAGGAGGCAA -> AACTTCAGCAGGAGGCAAG
AAAGAACGAACCCGGCAGC -> AAGAACGAACCCGGCAGCG
AAAGAGACTATAGGTATCC -> AAGAGACTATAGGTATCCG
AAAGCCCATACGGGCACTG -> AAGCCCATACGGGCACTGC
AAAGCTGGGCCTAACGACC -> AAGCTGGGCCTAACGACCG
AAAGGAACTAATAGAGAAG -> AAGGAACTAATAGAGAAGG
AAAGGCGGGCCGTGCGAAA -> AAGGCGGGCCGTGCGAAAT
AAAGGCGGTCGGACCCTCG -> AAGGCGGTCGGACCCTCGT
AAAGTTTATCTGTGAGTTA -> AAGTTTATCTGTGAGTTAT
AAATAATAACATATATGAA -> AATAATAACATATATGAAA
AAATAATTTTTATGAGAGG -> AATAATTTTTATGAGAGGT
AAATACTAGACTCGGGGGA -> AATACTAGACTCGGGGGAG
AAATAGTTCAAATGGGTCT -> AATAGTTCAAATGGGTCTG
AAATCCAAATAGTTCAAAT -> AATCCAAATAGTTCAAATG
AAATCGCTTTTGTTAATGG -> AATCGCTTTTGTTAATGGG
AAATGAGACTATAACAAGC -> AATGAGACTATAACAAGCT
AAATGGCTGCAACGTGTCG -> AATGGCTGCAACGTGTCGC
AAATGGGTCTGAGAGTTGG -> AATGGGTCTGAGAGTTGGG
AAATGTATCTCACGTAAAT -> AATGTATCTCACGTAAATG
AAATGTCGTTCCGCCAGGG -> AATGTCGTTCCGCCAGGGT
AAATGTCTGACCAGAGTAC -> AATGTCTGACCAGAGTACT
AAATTGTGGTTAGACTAGA -> AATTGTGGTTAGACTAGAT
AAATTTGGCGAGTTGAAAA -> AATTTGGCGAGTTGAAAAA
AACAAAGGAACTAATAGAG -> ACAAAGGAACTAATAGAGA
AACAAATTTGGCGAGTTGA -> ACAAATTTGGCGAGTTGAA
AACAACGAATCTTCTCATA -> ACAACGAATCTTCTCATAT
AACAAGCTTTCAAGCATTC -> ACAAGCTTTCAAGCATTCG
AACACGCTACCAGACCTGG -> ACACGCTACCAGACCTGGT
AACACTGATGGATGCGACT -> ACACTGATGGATGCGACTC
AACAGGGAATGGTTAGGGT -> ACAGGGAATGGTTAGGGTG
AACATATATGAAATCGCTT -> ACATATATGAAATCGCTTT
AACATCAGGAACCAGTCCA -> ACATCAGGAACCAGTCCAC
AACATGGCCGCATTCGCAA -> ACATGGCCGCATTCGCAAC
AACATGTGATGTTTCTTTA -> ACATGTGATGTTTCTTTAA
AACCAATTTCCCGTACATA -> ACCAATTTCCCGTACATAT
AACCAGTCCACATAGTCAA -> ACCAGTCCACATAGTCAAT
AACCATCTGAGGATGCGAC -> ACCATCTGAGGATGCGACG
AACCCACCATCCCAATGTA -> ACCCACCATCCCAATGTAA
AACCCACGGCGGACGGGAT -> ACCCACGGCGGACGGGATA
AACCCGGCAGCGATGCTCC -> ACCCGGCAGCGATGCTCCG
AACCGAAACCGGCGTTGAA -> ACCGAAACCGGCGTTGAAC
AACCGACAATTTGCATCGA -> ACCGACAATTTGCATCGAA
AACCGGCGTTGAACAACGA -> ACCGGCGTTGAACAACGAA
AACCTAAATGTCTGACCAG -> ACCTAAATGTCTGACCAGA
AACCTGGGACACGAGTATG -> ACCTGGGACACGAGTATGA
AACGAACCCGGCAGCGATG -> ACGAACCCGGCAGCGATGC
AACGAATCTTCTCATATGA -> ACGAATCTTCTCATATGAT
AACGACCGCGTGAGCCCAC -> ACGACCGCGTGAGCCCACT
AACGCGTATGTCACACTAT -> ACGCGTATGTCACACTATC
AACGGCAATCTAGCCGTAG -> ACGGCAATCTAGCCGTAGG
AACGTCGACTTCAGACGAC -> ACGTCGACTTCAGACGACA
AACGTGTCGCACTGAGTGA -> ACGTGTCGCACTGAGTGAA
AACGTTTGAGGCTGTACTG -> ACGTTTGAGGCTGTACTGT
AACTAATAGAGAAGGTAGG -> ACTAATAGAGAAGGTAGGA
AACTAGACCCATTGGTCCG -> ACTAGACCCATTGGTCCGA
AACTCATCGTAGGCACTTG -> ACTCATCGTAGGCACTTGA
AACTCCGGTTTTTTGCCCT -> ACTCCGGTTTTTTGCCCTT
AACTGCTAGTAGCTACAGG -> ACTGCTAGTAGCTACAGGT
AACTTCAGCAGGAGGCAAG -> ACTTCAGCAGGAGGCAAGG
AAGAAAGAGACTATAGGTA -> AGAAAGAGACTATAGGTAT
AAGAACGAACCCGGCAGCG -> AGAACGAACCCGGCAGCGA
AAGAGACTATAGGTATCCG -> AGAGACTATAGGTATCCGT
AAGATAACTGCTAGTAGCT -> AGATAACTGCTAGTAGCTA
AAGATGGCGCTTGCGGAAA -> AGATGGCGCTTGCGGAAAC
AAGCATTCGTCTCCAATAC -> AGCATTCGTCTCCAATACC
AAGCCCATACGGGCACTGC -> AGCCCATACGGGCACTGCT
AAGCTGGGCCTAACGACCG -> AGCTGGGCCTAACGACCGC
AAGCTTTCAAGCATTCGTC -> AGCTTTCAAGCATTCGTCT
AAGGAACTAATAGAGAAGG -> AGGAACTAATAGAGAAGGT
AAGGCGGGCCGTGCGAAAT -> AGGCGGGCCGTGCGAAATG
AAGGCGGTCGGACCCTCGT -> AGGCGGTCGGACCCTCGTC
AAGGGCCGCTCATCCGATG -> AGGGCCGCTCATCCGATGA
AAGGGCCTATCCGGCTCAA -> AGGGCCTATCCGGCTCAAT
AAGGTAGGACGTCGACTTC -> AGGTAGGACGTCGACTTCA
AAGGTCAGATGTCGCCGTG -> AGGTCAGATGTCGCCGTGT
AAGTATGGAGCGGTCAACA -> AGTATGGAGCGGTCAACAG
AAGTCCACTAGCTATATCT -> AGTCCACTAGCTATATCTG
AAGTGCGAGGGCAACCGAA -> AGTGCGAGGGCAACCGAAA
AAGTGGCTACTTCTCCGAC -> AGTGGCTACTTCTCCGACT
AAGTGTTTGACACCAAAAG -> AGTGTTTGACACCAAAAGG
AAGTTTATCTGTGAGTTAT -> AGTTTATCTGTGAGTTATG
AATAAACATGTGATGTTTC -> ATAAACATGTGATGTTTCT
AATAAACGCGTATGTCACA -> ATAAACGCGTATGTCACAC
AATAAATAATTTTTATGAG -> ATAAATAATTTTTATGAGA
AATAACATATATGAAATCG -> ATAACATATATGAAATCGC
AATAATAACATATATGAAA -> ATAATAACATATATGAAAT
AATAATTTTTATGAGAGGT -> ATAATTTTTATGAGAGGTT
AATACCAATCACTTGGCGA -> ATACCAATCACTTGGCGAC
AATACCTACTCTTCGCCGG -> ATACCTACTCTTCGCCGGG
AATACTAGACTCGGGGGAG -> ATACTAGACTCGGGGGAGT
AATACTTAAACAAATTTGG -> ATACTTAAACAAATTTGGC
AATAGAACCTAAATGTCTG -> ATAGAACCTAAATGTCTGA
AATAGAGAAGGTAGGACGT -> ATAGAGAAGGTAGGACGTC
AATAGTTCAAATGGGTCTG -> ATAGTTCAAATGGGTCTGA
AATATAAACTCCGGTTTTT -> ATATAAACTCCGGTTTTTT
AATCAACGTCGACTTCAGA -> ATCAACGTCGACTTCAGAC
AATCACTAATACCAATCAC -> ATCACTAATACCAATCACT
AATCACTTGGCGACAATTA -> ATCACTTGGCGACAATTAC
AATCCAAATAGTTCAAATG -> ATCCAAATAGTTCAAATGG
AATCCACCGAGTTACAGCC -> ATCCACCGAGTTACAGCCA
AATCGCTTTTGTTAATGGG -> ATCGCTTTTGTTAATGGGA
AATCGGATCACTAGTTTCA -> ATCGGATCACTAGTTTCAC
AATCGGTCAGCCTTGGTCT -> ATCGGTCAGCCTTGGTCTT
AATCTAGCCGTAGGTTGAT -> ATCTAGCCGTAGGTTGATG
AATCTCAGAGGAGACGGTT -> ATCTCAGAGGAGACGGTTA
AATCTCCTTCTTGCTCAGA -> ATCTCCTTCTTGCTCAGAG
AATCTTCTCATATGATTTT -> ATCTTCTCATATGATTTTC
AATGAGACTATAACAAGCT -> ATGAGACTATAACAAGCTT
AATGCGATGACGGTACAGG -> ATGCGATGACGGTACAGGA
AATGGCTGCAACGTGTCGC -> ATGGCTGCAACGTGTCGCA
AATGGGACTCCCGGAAACT -> ATGGGACTCCCGGAAACTT
AATGGGGGACCGATCGGCT -> ATGGGGGACCGATCGGCTA
AATGGGTCTGAGAGTTGGG -> ATGGGTCTGAGAGTTGGGG
AATGGTTAGGGTGTTTGAA -> ATGGTTAGGGTGTTTGAAA
AATGTAATCAACGTCGACT -> ATGTAATCAACGTCGACTT
AATGTATCTCACGTAAATG -> ATGTATCTCACGTAAATGA
AATGTCGTTCCGCCAGGGT -> ATGTCGTTCCGCCAGGGTT
AATGTCTGACCAGAGTACT -> ATGTCTGACCAGAGTACTC
AATTACACACAACATGGCC -> ATTACACACAACATGGCCG
AATTACCAAAAAGCTGGGC -> ATTACCAAAAAGCTGGGCC
AATTCAGGTGTCCTTATGG -> ATTCAGGTGTCCTTATGGA
AATTGTGGTTAGACTAGAT -> ATTGTGGTTAGACTAGATT
AATTGTTTACCATGGGCGT -> ATTGTTTACCATGGGCGTA
AATTTCCCGTACATATTCA -> ATTTCCCGTACATATTCAC
AATTTGCATCGAACAAAGG -> ATTTGCATCGAACAAAGGA
AATTTGGCGAGTTGAAAAA -> ATTTGGCGAGTTGAAAAAA
AATTTTTATGAGAGGTTTG -> ATTTTTATGAGAGGTTTGG
ACAAAATAATAACATATAT -> CAAAATAATAACATATATG
ACAAAGGAACTAATAGAGA -> CAAAGGAACTAATAGAGAA
ACAAATCCAAATAGTTCAA -> CAAATCCAAATAGTTCAAA
ACAAATTTGGCGAGTTGAA -> CAAATTTGGCGAGTTGAAA
ACAACATGGCCGCATTCGC -> CAACATGGCCGCATTCGCA
ACAACCGACAATTTGCATC -> CAACCGACAATTTGCATCG
ACAACGAATCTTCTCATAT -> CAACGAATCTTCTCATATG
ACAAGCTTTCAAGCATTCG -> CAAGCTTTCAAGCATTCGT
ACAAGTGCGAGGGCAACCG -> CAAGTGCGAGGGCAACCGA
ACAATCTCAGAGGAGACGG -> CAATCTCAGAGGAGACGGT
ACAATTACCAAAAAGCTGG -> CAATTACCAAAAAGCTGGG
ACAATTTGCATCGAACAAA -> CAATTTGCATCGAACAAAG
ACACAACATGGCCGCATTC -> CACAACATGGCCGCATTCG
ACACACAACATGGCCGCAT -> CACACAACATGGCCGCATT
ACACCAAAAGGCGGTCGGA -> CACCAAAAGGCGGTCGGAC
ACACGAAGTATGGAGCGGT -> CACGAAGTATGGAGCGGTC
ACACGAGTATGATACATTT -> CACGAGTATGATACATTTT
ACACGCTACCAGACCTGGT -> CACGCTACCAGACCTGGTT
ACACTATCGCATTATCATT -> CACTATCGCATTATCATTA
ACACTATTGGAAGTGTTTG -> CACTATTGGAAGTGTTTGA
ACACTGATGGATGCGACTC -> CACTGATGGATGCGACTCT
ACAGCCAATAAACATGTGA -> CAGCCAATAAACATGTGAT
ACAGGAGATCTTTCTTTGT -> CAGGAGATCTTTCTTTGTC
ACAGGGAATGGTTAGGGTG -> CAGGGAATGGTTAGGGTGT
ACAGGTCCCAGAAGTGGCT -> CAGGTCCCAGAAGTGGCTA
ACAGGTGGACATCGATGGT -> CAGGTGGACATCGATGGTG
ACAGTCCTGTACGGTAAAC -> CAGTCCTGTACGGTAAACA
ACATAGTCAATTGTTTACC -> CATAGTCAATTGTTTACCA
ACATATAATTCAGGTGTCC -> CATATAATTCAGGTGTCCT
ACATATATGAAATCGCTTT -> CATATATGAAATCGCTTTT
ACATATTCACTGCATTTAT -> CATATTCACTGCATTTATG
ACATCAGGAACCAGTCCAC -> CATCAGGAACCAGTCCACA
ACATCGATGGTGCCCGCTG -> CATCGATGGTGCCCGCTGA
ACATGGCCACAAGTGCGAG -> CATGGCCACAAGTGCGAGG
ACATGGCCATGGAATACTT -> CATGGCCATGGAATACTTA
ACATGGCCGCATTCGCAAC -> CATGGCCGCATTCGCAACC
ACATGGGGAACGGCAATCT -> CATGGGGAACGGCAATCTA
ACATGTGATGTTTCTTTAA -> CATGTGATGTTTCTTTAAT
ACATGTTGATTTGCCGCCA -> CATGTTGATTTGCCGCCAG
ACATTTTCTGTATGCAAAG -> CATTTTCTGTATGCAAAGA
ACCAAAAAGCTGGGCCTAA -> CCAAAAAGCTGGGCCTAAC
ACCAAAAGGCGGTCGGACC -> CCAAAAGGCGGTCGGACCC
ACCAAATACTAGACTCGGG -> CCAAATACTAGACTCGGGG
ACCAATCACTTGGCGACAA -> CCAATCACTTGGCGACAAT
ACCAATTTCCCGTACATAT -> CCAATTTCCCGTACATATT
ACCACTTTAAAAAAGTTTA -> CCACTTTAAAAAAGTTTAT
ACCAGACCTGGTTGTTGCT -> CCAGACCTGGTTGTTGCTG
ACCAGAGTACTCATAACAC -> CCAGAGTACTCATAACACT
ACCAGTCCACATAGTCAAT -> CCAGTCCACATAGTCAATT
ACCATCCCAATGTAATCAA -> CCATCCCAATGTAATCAAC
ACCATCTGAGGATGCGACG -> CCATCTGAGGATGCGACGC
ACCATCTGGAGCGGGAGTA -> CCATCTGGAGCGGGAGTAC
ACCATGGGCGTATAGGGGG -> CCATGGGCGTATAGGGGGG
ACCATTGCGCGTGCCGCCA -> CCATTGCGCGTGCCGCCAG
ACCCAAGATGGCGCTTGCG -> CCCAAGATGGCGCTTGCGG
ACCCAATGGGGGACCGATC -> CCCAATGGGGGACCGATCG
ACCCACCATCCCAATGTAA -> CCCACCATCCCAATGTAAT
ACCCACGGCGGACGGGATA -> CCCACGGCGGACGGGATAG
ACCCAGTGAGATTTGGCCT -> CCCAGTGAGATTTGGCCTC
ACCCATTGGTCCGACAACC -> CCCATTGGTCCGACAACCG
ACCCGCCAGGGTTCGTCTG -> CCCGCCAGGGTTCGTCTGA
ACCCGGCAGCGATGCTCCG -> CCCGGCAGCGATGCTCCGA
ACCCTCGTCGGTACATGGG -> CCCTCGTCGGTACATGGGG
ACCGAAACCGGCGTTGAAC -> CCGAAACCGGCGTTGAACA
ACCGACAATTTGCATCGAA -> CCGACAATTTGCATCGAAC
ACCGAGTTACAGCCAATAA -> CCGAGTTACAGCCAATAAA
ACCGATCGGCTAGCTGCAC -> CCGATCGGCTAGCTGCACA
ACCGCGTGAGCCCACTAAG -> CCGCGTGAGCCCACTAAGT
ACCGGCGTTGAACAACGAA -> CCGGCGTTGAACAACGAAT
ACCGGTGAGTCCACTGAAT -> CCGGTGAGTCCACTGAATA
ACCGTTCCGGGTACAAATC -> CCGTTCCGGGTACAAATCC
ACCTAAATGTCTGACCAGA -> CCTAAATGTCTGACCAGAG
ACCTACTCTTCGCCGGGAA -> CCTACTCTTCGCCGGGAAG
ACCTGGGACACGAGTATGA -> CCTGGGACACGAGTATGAT
ACCTGGTTGTTGCTGAAAG -> CCTGGTTGTTGCTGAAAGG
ACGAAATGTCGTTCCGCCA -> CGAAATGTCGTTCCGCCAG
ACGAACCCGGCAGCGATGC -> CGAACCCGGCAGCGATGCT
ACGAAGTATGGAGCGGTCA -> CGAAGTATGGAGCGGTCAA
ACGAATCTTCTCATATGAT -> CGAATCTTCTCATATGATT
ACGACATGTTGATTTGCCG -> CGACATGTTGATTTGCCGC
ACGACCATTGCGCGTGCCG -> CGACCATTGCGCGTGCCGC
ACGACCGCGTGAGCCCACT -> CGACCGCGTGAGCCCACTA
ACGACGAAATGTCGTTCCG -> CGACGAAATGTCGTTCCGC
ACGACTGATTCCTTACCCG -> CGACTGATTCCTTACCCGC
ACGAGTAGGGGCCTCCACA -> CGAGTAGGGGCCTCCACAC
ACGAGTATGATACATTTTC -> CGAGTATGATACATTTTCT
ACGCCCAGATGACTATGAC -> CGCCCAGATGACTATGACA
ACGCGAGATACGCCCAGAT -> CGCGAGATACGCCCAGATG
ACGCGTATGTCACACTATC -> CGCGTATGTCACACTATCG
ACGCTACCAGACCTGGTTG -> CGCTACCAGACCTGGTTGT
ACGCTCATTGGAGAGTAGA -> CGCTCATTGGAGAGTAGAA
ACGCTCTTAGGTTATGCCG -> CGCTCTTAGGTTATGCCGC
ACGGCAATCTAGCCGTAGG -> CGGCAATCTAGCCGTAGGT
ACGGCGGACGGGATAGAGT -> CGGCGGACGGGATAGAGTC
ACGGGATAGAGTCTCGCAC -> CGGGATAGAGTCTCGCACT
ACGGGCACTGCTCAGAGGA -> CGGGCACTGCTCAGAGGAA
ACGGTAAACATCAGGAACC -> CGGTAAACATCAGGAACCA
ACGGTACAGGAGATCTTTC -> CGGTACAGGAGATCTTTCT
ACGGTGGGTTCATACGTCG -> CGGTGGGTTCATACGTCGA
ACGGTTACACTATTGGAAG -> CGGTTACACTATTGGAAGT
ACGGTTGCACCAAATACTA -> CGGTTGCACCAAATACTAG
ACGTAAATGAGACTATAAC -> CGTAAATGAGACTATAACA
ACGTATAACCCACCATCCC -> CGTATAACCCACCATCCCA
ACGTATGGCCGGTCACCAT -> CGTATGGCCGGTCACCATC
ACGTCGACTTCAGACGACA -> CGTCGACTTCAGACGACAT
ACGTCGACTTCAGACGACC -> CGTCGACTTCAGACGACCA
ACGTCGACTTCAGACGACG -> CGTCGACTTCAGACGACGA
ACGTCGACTTCAGACGACT -> CGTCGACTTCAGACGACTG
ACGTGTCGCACTGAGTGAA -> CGTGTCGCACTGAGTGAAT
ACGTTTGAGGCTGTACTGT -> CGTTTGAGGCTGTACTGTG
ACTAAGTCCACTAGCTATA -> CTAAGTCCACTAGCTATAT
ACTAATACCAATCACTTGG -> CTAATACCAATCACTTGGC
ACTAATAGAGAAGGTAGGA -> CTAATAGAGAAGGTAGGAC
ACTACATGGCCATGGAATA -> CTACATGGCCATGGAATAC
ACTACGAGTAGGGGCCTCC -> CTACGAGTAGGGGCCTCCA
ACTAGACCCATTGGTCCGA -> CTAGACCCATTGGTCCGAC
ACTAGACTCGGGGGAGTTC -> CTAGACTCGGGGGAGTTCC
ACTAGATTTGCACGTCGAC -> CTAGATTTGCACGTCGACT
ACTAGCTATATCTGCGCAG -> CTAGCTATATCTGCGCAGC
ACTAGTTTCACCCAGTGAG -> CTAGTTTCACCCAGTGAGA
ACTATAACAAGCTTTCAAG -> CTATAACAAGCTTTCAAGC
ACTATAGGTATCCGTGATG -> CTATAGGTATCCGTGATGA
ACTATCGCATTATCATTAG -> CTATCGCATTATCATTAGC
ACTATGACAGGTCCCAGAA -> CTATGACAGGTCCCAGAAG
ACTATTGGAAGTGTTTGAC -> CTATTGGAAGTGTTTGACA
ACTCATAACACTGATGGAT -> CTCATAACACTGATGGATG
ACTCATCGACAATCTCAGA -> CTCATCGACAATCTCAGAG
ACTCATCGTAGGCACTTGA -> CTCATCGTAGGCACTTGAG
ACTCCCGGAAACTTCAGCA -> CTCCCGGAAACTTCAGCAG
ACTCCGAATTACACACAAC -> CTCCGAATTACACACAACA
ACTCCGGTTTTTTGCCCTT -> CTCCGGTTTTTTGCCCTTT
ACTCGCCGACAAAATAATA -> CTCGCCGACAAAATAATAA
ACTCGCCTAGGCAAACCTG -> CTCGCCTAGGCAAACCTGG
ACTCGGGGGAGTTCCGTGG -> CTCGGGGGAGTTCCGTGGC
ACTCTCCCGGGATATGCGG -> CTCTCCCGGGATATGCGGC
ACTCTTCGCCGGGAAGGGC -> CTCTTCGCCGGGAAGGGCC
ACTGAATAGAACCTAAATG -> CTGAATAGAACCTAAATGT
ACTGAGTGAATGCGATGAC -> CTGAGTGAATGCGATGACG
ACTGATCGAGCCGGTTCTA -> CTGATCGAGCCGGTTCTAG
ACTGATGGATGCGACTCTC -> CTGATGGATGCGACTCTCC
ACTGATTCCTTACCCGCCA -> CTGATTCCTTACCCGCCAG
ACTGCATTTATGTATGGTT -> CTGCATTTATGTATGGTTT
ACTGCTACTGATCGAGCCG -> CTGCTACTGATCGAGCCGG
ACTGCTAGTAGCTACAGGT -> CTGCTAGTAGCTACAGGTG
ACTGCTCAGAGGAATATAA -> CTGCTCAGAGGAATATAAA
ACTGTGGGAAATTGTGGTT -> CTGTGGGAAATTGTGGTTA
ACTTAAACAAATTTGGCGA -> CTTAAACAAATTTGGCGAG
ACTTCAGACGACATGTTGA -> CTTCAGACGACATGTTGAT
ACTTCAGACGACCATTGCG -> CTTCAGACGACCATTGCGC
ACTTCAGACGACGAAATGT -> CTTCAGACGACGAAATGTC
ACTTCAGACGACTGATTCC -> CTTCAGACGACTGATTCCT
ACTTCAGCAGGAGGCAAGG -> CTTCAGCAGGAGGCAAGGT
ACTTCTCCGACTCATCGAC -> CTTCTCCGACTCATCGACA
ACTTGAGTGGAGGAAAAAA -> CTTGAGTGGAGGAAAAAAC
ACTTGGCGACAATTACCAA -> CTTGGCGACAATTACCAAA
ACTTTAAAAAAGTTTATCT -> CTTTAAAAAAGTTTATCTG
AGAAAGAGACTATAGGTAT -> GAAAGAGACTATAGGTATC
AGAACCTAAATGTCTGACC -> GAACCTAAATGTCTGACCA
AGAACGAACCCGGCAGCGA -> GAACGAACCCGGCAGCGAT
AGAAGAAAGAGACTATAGG -> GAAGAAAGAGACTATAGGT
AGAAGGTAGGACGTCGACT -> GAAGGTAGGACGTCGACTT
AGAAGTGGCTACTTCTCCG -> GAAGTGGCTACTTCTCCGA
AGAATCTCCTTCTTGCTCA -> GAATCTCCTTCTTGCTCAG
AGACCCATTGGTCCGACAA -> GACCCATTGGTCCGACAAC
AGACCGGTGAGTCCACTGA -> GACCGGTGAGTCCACTGAA
AGACCTGGTTGTTGCTGAA -> GACCTGGTTGTTGCTGAAA
AGACGACATGTTGATTTGC -> GACGACATGTTGATTTGCC
AGACGACCATTGCGCGTGC -> GACGACCATTGCGCGTGCC
AGACGACGAAATGTCGTTC -> GACGACGAAATGTCGTTCC
AGACGACTGATTCCTTACC -> GACGACTGATTCCTTACCC
AGACGGTTACACTATTGGA -> GACGGTTACACTATTGGAA
AGACTAGATTTGCACGTCG -> GACTAGATTTGCACGTCGA
AGACTATAACAAGCTTTCA -> GACTATAACAAGCTTTCAA
AGACTATAGGTATCCGTGA -> GACTATAGGTATCCGTGAT
AGACTCGGGGGAGTTCCGT -> GACTCGGGGGAGTTCCGTG
AGAGAAGGTAGGACGTCGA -> GAGAAGGTAGGACGTCGAC
AGAGACTATAGGTATCCGT -> GAGACTATAGGTATCCGTG
AGAGCACATGGCCACAAGT -> GAGCACATGGCCACAAGTG
AGAGGAATATAAACTCCGG -> GAGGAATATAAACTCCGGT
AGAGGACTCGCCGACAAAA -> GAGGACTCGCCGACAAAAT
AGAGGAGACGGTTACACTA -> GAGGAGACGGTTACACTAT
AGAGGTTTGGCACGGTTGC -> GAGGTTTGGCACGGTTGCA
AGAGTACTCATAACACTGA -> GAGTACTCATAACACTGAT
AGAGTAGAAGAAAGAGACT -> GAGTAGAAGAAAGAGACTA
AGAGTCTCGCACTACGAGT -> GAGTCTCGCACTACGAGTA
AGAGTTGGGGTGGCAGAGC -> GAGTTGGGGTGGCAGAGCA
AGATAACTGCTAGTAGCTA -> GATAACTGCTAGTAGCTAC
AGATACGCCCAGATGACTA -> GATACGCCCAGATGACTAT
AGATCTTTCTTTGTCACGT -> GATCTTTCTTTGTCACGTA
AGATGACTATGACAGGTCC -> GATGACTATGACAGGTCCC
AGATGGCGCTTGCGGAAAC -> GATGGCGCTTGCGGAAACT
AGATGTCGCCGTGTGTAGC -> GATGTCGCCGTGTGTAGCA
AGATTTGCACGTCGACTTC -> GATTTGCACGTCGACTTCA
AGATTTGGCCTCTGGAACT -> GATTTGGCCTCTGGAACTA
AGCAAGATAACTGCTAGTA -> GCAAGATAACTGCTAGTAG
AGCAATAAATAATTTTTAT -> GCAATAAATAATTTTTATG
AGCACATGGCCACAAGTGC -> GCACATGGCCACAAGTGCG
AGCACGCTCATTGGAGAGT -> GCACGCTCATTGGAGAGTA
AGCAGGAGGCAAGGTCAGA -> GCAGGAGGCAAGGTCAGAT
AGCATTCGTCTCCAATACC -> GCATTCGTCTCCAATACCT
AGCCAATAAACATGTGATG -> GCCAATAAACATGTGATGT
AGCCCACTAAGTCCACTAG -> GCCCACTAAGTCCACTAGC
AGCCCATACGGGCACTGCT -> GCCCATACGGGCACTGCTC
AGCCGGTTCTAGTCTAGAA -> GCCGGTTCTAGTCTAGAAT
AGCCGTAGGTTGATGGCAT -> GCCGTAGGTTGATGGCATC
AGCCTTGGTCTTCATGGAT -> GCCTTGGTCTTCATGGATT
AGCGATGCTCCGACCACTT -> GCGATGCTCCGACCACTTT
AGCGCAACCAATTTCCCGT -> GCGCAACCAATTTCCCGTA
AGCGGGAGTACTGCTACTG -> GCGGGAGTACTGCTACTGA
AGCGGTCAACAGGGAATGG -> GCGGTCAACAGGGAATGGT
AGCTAATCCACCGAGTTAC -> GCTAATCCACCGAGTTACA
AGCTACAGGTGGACATCGA -> GCTACAGGTGGACATCGAT
AGCTATATCTGCGCAGCGC -> GCTATATCTGCGCAGCGCA
AGCTGCACATATAATTCAG -> GCTGCACATATAATTCAGG
AGCTGGGCCTAACGACCGC -> GCTGGGCCTAACGACCGCG
AGCTTTCAAGCATTCGTCT -> GCTTTCAAGCATTCGTCTC
AGGAAAAAACCATCTGAGG -> GGAAAAAACCATCTGAGGA
AGGAACCAGTCCACATAGT -> GGAACCAGTCCACATAGTC
AGGAACTAATAGAGAAGGT -> GGAACTAATAGAGAAGGTA
AGGAATATAAACTCCGGTT -> GGAATATAAACTCCGGTTT
AGGACGTCGACTTCAGACG -> GGACGTCGACTTCAGACGA
AGGACTCGCCGACAAAATA -> GGACTCGCCGACAAAATAA
AGGAGACGGTTACACTATT -> GGAGACGGTTACACTATTG
AGGAGATCTTTCTTTGTCA -> GGAGATCTTTCTTTGTCAC
AGGAGGCAAGGTCAGATGT -> GGAGGCAAGGTCAGATGTC
AGGATGCGACGCGAGATAC -> GGATGCGACGCGAGATACG
AGGCAAACCTGGGACACGA -> GGCAAACCTGGGACACGAG
AGGCAAGGTCAGATGTCGC -> GGCAAGGTCAGATGTCGCC
AGGCACTTGAGTGGAGGAA -> GGCACTTGAGTGGAGGAAA
AGGCGGGCCGTGCGAAATG -> GGCGGGCCGTGCGAAATGT
AGGCGGTCGGACCCTCGTC -> GGCGGTCGGACCCTCGTCG
AGGCTGTACTGTGGGAAAT -> GGCTGTACTGTGGGAAATT
AGGGAATGGTTAGGGTGTT -> GGGAATGGTTAGGGTGTTT
AGGGCAACCGAAACCGGCG -> GGGCAACCGAAACCGGCGT
AGGGCCGCTCATCCGATGA -> GGGCCGCTCATCCGATGAG
AGGGCCTATCCGGCTCAAT -> GGGCCTATCCGGCTCAATC
AGGGGCCTCCACACGAAGT -> GGGGCCTCCACACGAAGTA
AGGGGGGAGTTGCACCCAA -> GGGGGGAGTTGCACCCAAT
AGGGTGTTTGAAATGGCTG -> GGGTGTTTGAAATGGCTGC
AGGGTTCGTCTGACCCAAG -> GGGTTCGTCTGACCCAAGA
AGGGTTCGTCTGACGCTCT -> GGGTTCGTCTGACGCTCTT
AGGGTTCGTCTGACGGTGG -> GGGTTCGTCTGACGGTGGG
AGGGTTCGTCTGACTCGCC -> GGGTTCGTCTGACTCGCCT
AGGTAGGACGTCGACTTCA -> GGTAGGACGTCGACTTCAG
AGGTATCCGTGATGATGGA -> GGTATCCGTGATGATGGAC
AGGTCAGATGTCGCCGTGT -> GGTCAGATGTCGCCGTGTG
AGGTCCCAGAAGTGGCTAC -> GGTCCCAGAAGTGGCTACT
AGGTGGACATCGATGGTGC -> GGTGGACATCGATGGTGCC
AGGTGTCCTTATGGAATCG -> GGTGTCCTTATGGAATCGG
AGGTTATGCCGCCAGACCG -> GGTTATGCCGCCAGACCGG
AGGTTGATGGCATCCGGAT -> GGTTGATGGCATCCGGATT
AGGTTTGGCACGGTTGCAC -> GGTTTGGCACGGTTGCACC
AGTACTCATAACACTGATG -> GTACTCATAACACTGATGG
AGTACTGCTACTGATCGAG -> GTACTGCTACTGATCGAGC
AGTAGAAGAAAGAGACTAT -> GTAGAAGAAAGAGACTATA
AGTAGCTACAGGTGGACAT -> GTAGCTACAGGTGGACATC
AGTAGGGGCCTCCACACGA -> GTAGGGGCCTCCACACGAA
AGTATGATACATTTTCTGT -> GTATGATACATTTTCTGTA
AGTATGGAGCGGTCAACAG -> GTATGGAGCGGTCAACAGG
AGTCAATTGTTTACCATGG -> GTCAATTGTTTACCATGGG
AGTCCACATAGTCAATTGT -> GTCCACATAGTCAATTGTT
AGTCCACTAGCTATATCTG -> GTCCACTAGCTATATCTGC
AGTCCACTGAATAGAACCT -> GTCCACTGAATAGAACCTA
AGTCCTGTACGGTAAACAT -> GTCCTGTACGGTAAACATC
AGTCTAGAATCTCCTTCTT -> GTCTAGAATCTCCTTCTTG
AGTCTCGCACTACGAGTAG -> GTCTCGCACTACGAGTAGG
AGTGAATGCGATGACGGTA -> GTGAATGCGATGACGGTAC
AGTGAGATTTGGCCTCTGG -> GTGAGATTTGGCCTCTGGA
AGTGCGAGGGCAACCGAAA -> GTGCGAGGGCAACCGAAAC
AGTGGAGGAAAAAACCATC -> GTGGAGGAAAAAACCATCT
AGTGGCTACTTCTCCGACT -> GTGGCTACTTCTCCGACTC
AGTGTTTGACACCAAAAGG -> GTGTTTGACACCAAAAGGC
AGTTACAGCCAATAAACAT -> GTTACAGCCAATAAACATG
AGTTATGACGTATAACCCA -> GTTATGACGTATAACCCAC
AGTTCAAATGGGTCTGAGA -> GTTCAAATGGGTCTGAGAG
AGTTCCGTGGCCACCGTTC -> GTTCCGTGGCCACCGTTCC
AGTTGAAAAAAGCCCATAC -> GTTGAAAAAAGCCCATACG
AGTTGCACCCAATGGGGGA -> GTTGCACCCAATGGGGGAC
AGTTGGGGTGGCAGAGCAC -> GTTGGGGTGGCAGAGCACA
AGTTTATCTGTGAGTTATG -> GTTTATCTGTGAGTTATGA
AGTTTCACCCAGTGAGATT -> GTTTCACCCAGTGAGATTT
ATAAACATGTGATGTTTCT -> TAAACATGTGATGTTTCTT
ATAAACGCGTATGTCACAC -> TAAACGCGTATGTCACACT
ATAAACTCCGGTTTTTTGC -> TAAACTCCGGTTTTTTGCC
ATAAATAATTTTTATGAGA -> TAAATAATTTTTATGAGAG
ATAACAAGCTTTCAAGCAT -> TAACAAGCTTTCAAGCATT
ATAACACGCTACCAGACCT -> TAACACGCTACCAGACCTG
ATAACACTGATGGATGCGA -> TAACACTGATGGATGCGAC
ATAACATATATGAAATCGC -> TAACATATATGAAATCGCT
ATAACCCACCATCCCAATG -> TAACCCACCATCCCAATGT
ATAACTGCTAGTAGCTACA -> TAACTGCTAGTAGCTACAG
ATAATAACATATATGAAAT -> TAATAACATATATGAAATC
ATAATTCAGGTGTCCTTAT -> TAATTCAGGTGTCCTTATG
ATAATTTTTATGAGAGGTT -> TAATTTTTATGAGAGGTTT
ATACATTTTCTGTATGCAA -> TACATTTTCTGTATGCAAA
ATACCAATCACTTGGCGAC -> TACCAATCACTTGGCGACA
ATACCTACTCTTCGCCGGG -> TACCTACTCTTCGCCGGGA
ATACGCCCAGATGACTATG -> TACGCCCAGATGACTATGA
ATACGGGCACTGCTCAGAG -> TACGGGCACTGCTCAGAGG
ATACGTCGACTTCAGACGA -> TACGTCGACTTCAGACGAC
ATACTAGACTCGGGGGAGT -> TACTAGACTCGGGGGAGTT
ATACTTAAACAAATTTGGC -> TACTTAAACAAATTTGGCG
ATAGAACCTAAATGTCTGA -> TAGAACCTAAATGTCTGAC
ATAGAGAAGGTAGGACGTC -> TAGAGAAGGTAGGACGTCG
ATAGAGTCTCGCACTACGA -> TAGAGTCTCGCACTACGAG
ATAGCTAATCCACCGAGTT -> TAGCTAATCCACCGAGTTA
ATAGGGGGGAGTTGCACCC -> TAGGGGGGAGTTGCACCCA
ATAGGTATCCGTGATGATG -> TAGGTATCCGTGATGATGG
ATAGTCAATTGTTTACCAT -> TAGTCAATTGTTTACCATG
ATAGTTCAAATGGGTCTGA -> TAGTTCAAATGGGTCTGAG
ATATAAACTCCGGTTTTTT -> TATAAACTCCGGTTTTTTG
ATATAATTCAGGTGTCCTT -> TATAATTCAGGTGTCCTTA
ATATATGAAATCGCTTTTG -> TATATGAAATCGCTTTTGT
ATATCTGCGCAGCGCAACC -> TATCTGCGCAGCGCAACCA
ATATGAAATCGCTTTTGTT -> TATGAAATCGCTTTTGTTA
ATATGATTTTCGTGACAGT -> TATGATTTTCGTGACAGTC
ATATGCGGCGCTGATCCTT -> TATGCGGCGCTGATCCTTG
ATATTCACTGCATTTATGT -> TATTCACTGCATTTATGTA
ATCAACGTCGACTTCAGAC -> TCAACGTCGACTTCAGACG
ATCACTAATACCAATCACT -> TCACTAATACCAATCACTT
ATCACTAGTTTCACCCAGT -> TCACTAGTTTCACCCAGTG
ATCACTCCGAATTACACAC -> TCACTCCGAATTACACACA
ATCACTTGGCGACAATTAC -> TCACTTGGCGACAATTACC
ATCAGGAACCAGTCCACAT -> TCAGGAACCAGTCCACATA
ATCATTAGCAATAAATAAT -> TCATTAGCAATAAATAATT
ATCCAAATAGTTCAAATGG -> TCCAAATAGTTCAAATGGG
ATCCACCGAGTTACAGCCA -> TCCACCGAGTTACAGCCAA
ATCCCAATGTAATCAACGT -> TCCCAATGTAATCAACGTC
ATCCGATGAGCAAGATAAC -> TCCGATGAGCAAGATAACT
ATCCGGATTCGATCTTATT -> TCCGGATTCGATCTTATTT
ATCCGGCTCAATCACTAAT -> TCCGGCTCAATCACTAATA
ATCCGTGATGATGGACTAC -> TCCGTGATGATGGACTACA
ATCCTTGCCATCACTCCGA -> TCCTTGCCATCACTCCGAA
ATCGAACAAAGGAACTAAT -> TCGAACAAAGGAACTAATA
ATCGACAATCTCAGAGGAG -> TCGACAATCTCAGAGGAGA
ATCGAGCCGGTTCTAGTCT -> TCGAGCCGGTTCTAGTCTA
ATCGATGGTGCCCGCTGAT -> TCGATGGTGCCCGCTGATG
ATCGCATTATCATTAGCAA -> TCGCATTATCATTAGCAAT
ATCGCTTTTGTTAATGGGA -> TCGCTTTTGTTAATGGGAC
ATCGGATCACTAGTTTCAC -> TCGGATCACTAGTTTCACC
ATCGGCTAGCTGCACATAT -> TCGGCTAGCTGCACATATA
ATCGGTCAGCCTTGGTCTT -> TCGGTCAGCCTTGGTCTTC
ATCGTAGGCACTTGAGTGG -> TCGTAGGCACTTGAGTGGA
ATCTAGCCGTAGGTTGATG -> TCTAGCCGTAGGTTGATGG
ATCTCACGTAAATGAGACT -> TCTCACGTAAATGAGACTA
ATCTCAGAGGAGACGGTTA -> TCTCAGAGGAGACGGTTAC
ATCTCCTTCTTGCTCAGAG -> TCTCCTTCTTGCTCAGAGG
ATCTGAGGATGCGACGCGA -> TCTGAGGATGCGACGCGAG
ATCTGCGCAGCGCAACCAA -> TCTGCGCAGCGCAACCAAT
ATCTGGAGCGGGAGTACTG -> TCTGGAGCGGGAGTACTGC
ATCTGTGAGTTATGACGTA -> TCTGTGAGTTATGACGTAT
ATCTTATTTTGAAGGGCCG -> TCTTATTTTGAAGGGCCGC
ATCTTCTCATATGATTTTC -> TCTTCTCATATGATTTTCG
ATCTTTCTTTGTCACGTAT -> TCTTTCTTTGTCACGTATG
ATGAAATCGCTTTTGTTAA -> TGAAATCGCTTTTGTTAAT
ATGACAGGTCCCAGAAGTG -> TGACAGGTCCCAGAAGTGG
ATGACGGTACAGGAGATCT -> TGACGGTACAGGAGATCTT
ATGACGTATAACCCACCAT -> TGACGTATAACCCACCATC
ATGACTATGACAGGTCCCA -> TGACTATGACAGGTCCCAG
ATGAGACTATAACAAGCTT -> TGAGACTATAACAAGCTTT
ATGAGAGGTTTGGCACGGT -> TGAGAGGTTTGGCACGGTT
ATGAGCAAGATAACTGCTA -> TGAGCAAGATAACTGCTAG
ATGATACATTTTCTGTATG -> TGATACATTTTCTGTATGC
ATGATGGACTACATGGCCA -> TGATGGACTACATGGCCAT
ATGATTTTCGTGACAGTCC -> TGATTTTCGTGACAGTCCT
ATGCAAAGAACGAACCCGG -> TGCAAAGAACGAACCCGGC
ATGCCGCCAGACCGGTGAG -> TGCCGCCAGACCGGTGAGT
ATGCGACGCGAGATACGCC -> TGCGACGCGAGATACGCCC
ATGCGACTCTCCCGGGATA -> TGCGACTCTCCCGGGATAT
ATGCGATGACGGTACAGGA -> TGCGATGACGGTACAGGAG
ATGCGGCGCTGATCCTTGC -> TGCGGCGCTGATCCTTGCC
ATGCTCATAACACGCTACC -> TGCTCATAACACGCTACCA
ATGCTCCGACCACTTTAAA -> TGCTCCGACCACTTTAAAA
ATGGAATACTTAAACAAAT -> TGGAATACTTAAACAAATT
ATGGAATCGGATCACTAGT -> TGGAATCGGATCACTAGTT
ATGGACTACATGGCCATGG -> TGGACTACATGGCCATGGA
ATGGAGCGGTCAACAGGGA -> TGGAGCGGTCAACAGGGAA
ATGGATGCGACTCTCCCGG -> TGGATGCGACTCTCCCGGG
ATGGATTGTCTGGTTCTGT -> TGGATTGTCTGGTTCTGTA
ATGGCATCCGGATTCGATC -> TGGCATCCGGATTCGATCT
ATGGCCACAAGTGCGAGGG -> TGGCCACAAGTGCGAGGGC
ATGGCCATGGAATACTTAA -> TGGCCATGGAATACTTAAA
ATGGCCGCATTCGCAACCC -> TGGCCGCATTCGCAACCCA
ATGGCCGGTCACCATCTGG -> TGGCCGGTCACCATCTGGA
ATGGCGCTTGCGGAAACTC -> TGGCGCTTGCGGAAACTCA
ATGGCTGCAACGTGTCGCA -> TGGCTGCAACGTGTCGCAC
ATGGGACTCCCGGAAACTT -> TGGGACTCCCGGAAACTTC
ATGGGCGTATAGGGGGGAG -> TGGGCGTATAGGGGGGAGT
ATGGGGAACGGCAATCTAG -> TGGGGAACGGCAATCTAGC
ATGGGGGACCGATCGGCTA -> TGGGGGACCGATCGGCTAG
ATGGGTCTGAGAGTTGGGG -> TGGGTCTGAGAGTTGGGGT
ATGGTGCCCGCTGATGCTC -> TGGTGCCCGCTGATGCTCA
ATGGTTAGGGTGTTTGAAA -> TGGTTAGGGTGTTTGAAAT
ATGGTTTAAAAACGTTTGA -> TGGTTTAAAAACGTTTGAG
ATGTAATCAACGTCGACTT -> TGTAATCAACGTCGACTTC
ATGTATCTCACGTAAATGA -> TGTATCTCACGTAAATGAG
ATGTATGGTTTAAAAACGT -> TGTATGGTTTAAAAACGTT
ATGTCACACTATCGCATTA -> TGTCACACTATCGCATTAT
ATGTCGCCGTGTGTAGCAC -> TGTCGCCGTGTGTAGCACG
ATGTCGTTCCGCCAGGGTT -> TGTCGTTCCGCCAGGGTTC
ATGTCTGACCAGAGTACTC -> TGTCTGACCAGAGTACTCA
ATGTGATGTTTCTTTAATA -> TGTGATGTTTCTTTAATAA
ATGTTGATTTGCCGCCAGG -> TGTTGATTTGCCGCCAGGG
ATGTTTCTTTAATAAACGC -> TGTTTCTTTAATAAACGCG
ATTACACACAACATGGCCG -> TTACACACAACATGGCCGC
ATTACCAAAAAGCTGGGCC -> TTACCAAAAAGCTGGGCCT
ATTAGCAATAAATAATTTT -> TTAGCAATAAATAATTTTT
ATTATCATTAGCAATAAAT -> TTATCATTAGCAATAAATA
ATTCACTGCATTTATGTAT -> TTCACTGCATTTATGTATG
ATTCAGGTGTCCTTATGGA -> TTCAGGTGTCCTTATGGAA
ATTCCTTACCCGCCAGGGT -> TTCCTTACCCGCCAGGGTT
ATTCGATCTTATTTTGAAG -> TTCGATCTTATTTTGAAGG
ATTCGCAACCCACGGCGGA -> TTCGCAACCCACGGCGGAC
ATTCGTCTCCAATACCTAC -> TTCGTCTCCAATACCTACT
ATTGCGCGTGCCGCCAGGG -> TTGCGCGTGCCGCCAGGGT
ATTGGAAGTGTTTGACACC -> TTGGAAGTGTTTGACACCA
ATTGGAGAGTAGAAGAAAG -> TTGGAGAGTAGAAGAAAGA
ATTGGTCCGACAACCGACA -> TTGGTCCGACAACCGACAA
ATTGTGGTTAGACTAGATT -> TTGTGGTTAGACTAGATTT
ATTGTTTACCATGGGCGTA -> TTGTTTACCATGGGCGTAT
ATTTATGTATGGTTTAAAA -> TTTATGTATGGTTTAAAAA
ATTTCCCGTACATATTCAC -> TTTCCCGTACATATTCACT
ATTTGCACGTCGACTTCAG -> TTTGCACGTCGACTTCAGA
ATTTGCATCGAACAAAGGA -> TTTGCATCGAACAAAGGAA
ATTTGCCGCCAGGGTTCGT -> TTTGCCGCCAGGGTTCGTC
ATTTGGCCTCTGGAACTAG -> TTTGGCCTCTGGAACTAGA
ATTTGGCGAGTTGAAAAAA -> TTTGGCGAGTTGAAAAAAG
ATTTTCGTGACAGTCCTGT -> TTTTCGTGACAGTCCTGTA
ATTTTCTGTATGCAAAGAA -> TTTTCTGTATGCAAAGAAC
ATTTTGAAGGGCCGCTCAT -> TTTTGAAGGGCCGCTCATC
ATTTTTATGAGAGGTTTGG -> TTTTTATGAGAGGTTTGGC
CAAAAAGCTGGGCCTAACG -> AAAAAGCTGGGCCTAACGA
CAAAAGGCGGTCGGACCCT -> AAAAGGCGGTCGGACCCTC
CAAAATAATAACATATATG -> AAAATAATAACATATATGA
CAAACCTGGGACACGAGTA -> AAACCTGGGACACGAGTAT
CAAAGAACGAACCCGGCAG -> AAAGAACGAACCCGGCAGC
CAAAGGAACTAATAGAGAA -> AAAGGAACTAATAGAGAAG
CAAATACTAGACTCGGGGG -> AAATACTAGACTCGGGGGA
CAAATAGTTCAAATGGGTC -> AAATAGTTCAAATGGGTCT
CAAATCCAAATAGTTCAAA -> AAATCCAAATAGTTCAAAT
CAAATGGGTCTGAGAGTTG -> AAATGGGTCTGAGAGTTGG
CAAATTTGGCGAGTTGAAA -> AAATTTGGCGAGTTGAAAA
CAACAGGGAATGGTTAGGG -> AACAGGGAATGGTTAGGGT
CAACATGGCCGCATTCGCA -> AACATGGCCGCATTCGCAA
CAACCAATTTCCCGTACAT -> AACCAATTTCCCGTACATA
CAACCCACGGCGGACGGGA -> AACCCACGGCGGACGGGAT
CAACCGAAACCGGCGTTGA -> AACCGAAACCGGCGTTGAA
CAACCGACAATTTGCATCG -> AACCGACAATTTGCATCGA
CAACGAATCTTCTCATATG -> AACGAATCTTCTCATATGA
CAACGTCGACTTCAGACGA -> AACGTCGACTTCAGACGAC
CAACGTGTCGCACTGAGTG -> AACGTGTCGCACTGAGTGA
CAAGATAACTGCTAGTAGC -> AAGATAACTGCTAGTAGCT
CAAGATGGCGCTTGCGGAA -> AAGATGGCGCTTGCGGAAA
CAAGCATTCGTCTCCAATA -> AAGCATTCGTCTCCAATAC
CAAGCTTTCAAGCATTCGT -> AAGCTTTCAAGCATTCGTC
CAAGGTCAGATGTCGCCGT -> AAGGTCAGATGTCGCCGTG
CAAGTGCGAGGGCAACCGA -> AAGTGCGAGGGCAACCGAA
CAATAAACATGTGATGTTT -> AATAAACATGTGATGTTTC
CAATAAATAATTTTTATGA -> AATAAATAATTTTTATGAG
CAATACCTACTCTTCGCCG -> AATACCTACTCTTCGCCGG
CAATCACTAATACCAATCA -> AATCACTAATACCAATCAC
CAATCACTTGGCGACAATT -> AATCACTTGGCGACAATTA
CAATCTAGCCGTAGGTTGA -> AATCTAGCCGTAGGTTGAT
CAATCTCAGAGGAGACGGT -> AATCTCAGAGGAGACGGTT
CAATGGGGGACCGATCGGC -> AATGGGGGACCGATCGGCT
CAATGTAATCAACGTCGAC -> AATGTAATCAACGTCGACT
CAATTACCAAAAAGCTGGG -> AATTACCAAAAAGCTGGGC
CAATTGTTTACCATGGGCG -> AATTGTTTACCATGGGCGT
CAATTTCCCGTACATATTC -> AATTTCCCGTACATATTCA
CAATTTGCATCGAACAAAG -> AATTTGCATCGAACAAAGG
CACAACATGGCCGCATTCG -> ACAACATGGCCGCATTCGC
CACAAGTGCGAGGGCAACC -> ACAAGTGCGAGGGCAACCG
CACACAACATGGCCGCATT -> ACACAACATGGCCGCATTC
CACACGAAGTATGGAGCGG -> ACACGAAGTATGGAGCGGT
CACACTATCGCATTATCAT -> ACACTATCGCATTATCATT
CACATAGTCAATTGTTTAC -> ACATAGTCAATTGTTTACC
CACATATAATTCAGGTGTC -> ACATATAATTCAGGTGTCC
CACATGGCCACAAGTGCGA -> ACATGGCCACAAGTGCGAG
CACCAAAAGGCGGTCGGAC -> ACCAAAAGGCGGTCGGACC
CACCAAATACTAGACTCGG -> ACCAAATACTAGACTCGGG
CACCATCCCAATGTAATCA -> ACCATCCCAATGTAATCAA
CACCATCTGGAGCGGGAGT -> ACCATCTGGAGCGGGAGTA
CACCCAATGGGGGACCGAT -> ACCCAATGGGGGACCGATC
CACCCAGTGAGATTTGGCC -> ACCCAGTGAGATTTGGCCT
CACCGAGTTACAGCCAATA -> ACCGAGTTACAGCCAATAA
CACCGTTCCGGGTACAAAT -> ACCGTTCCGGGTACAAATC
CACGAAGTATGGAGCGGTC -> ACGAAGTATGGAGCGGTCA
CACGAGTATGATACATTTT -> ACGAGTATGATACATTTTC
CACGCTACCAGACCTGGTT -> ACGCTACCAGACCTGGTTG
CACGCTCATTGGAGAGTAG -> ACGCTCATTGGAGAGTAGA
CACGGCGGACGGGATAGAG -> ACGGCGGACGGGATAGAGT
CACGGTTGCACCAAATACT -> ACGGTTGCACCAAATACTA
CACGTAAATGAGACTATAA -> ACGTAAATGAGACTATAAC
CACGTATGGCCGGTCACCA -> ACGTATGGCCGGTCACCAT
CACGTCGACTTCAGACGAC -> ACGTCGACTTCAGACGACC
CACTAAGTCCACTAGCTAT -> ACTAAGTCCACTAGCTATA
CACTAATACCAATCACTTG -> ACTAATACCAATCACTTGG
CACTACGAGTAGGGGCCTC -> ACTACGAGTAGGGGCCTCC
CACTAGCTATATCTGCGCA -> ACTAGCTATATCTGCGCAG
CACTAGTTTCACCCAGTGA -> ACTAGTTTCACCCAGTGAG
CACTATCGCATTATCATTA -> ACTATCGCATTATCATTAG
CACTATTGGAAGTGTTTGA -> ACTATTGGAAGTGTTTGAC
CACTCCGAATTACACACAA -> ACTCCGAATTACACACAAC
CACTGAATAGAACCTAAAT -> ACTGAATAGAACCTAAATG
CACTGAGTGAATGCGATGA -> ACTGAGTGAATGCGATGAC
CACTGATGGATGCGACTCT -> ACTGATGGATGCGACTCTC
CACTGCATTTATGTATGGT -> ACTGCATTTATGTATGGTT
CACTGCTCAGAGGAATATA -> ACTGCTCAGAGGAATATAA
CACTTGAGTGGAGGAAAAA -> ACTTGAGTGGAGGAAAAAA
CACTTGGCGACAATTACCA -> ACTTGGCGACAATTACCAA
CACTTTAAAAAAGTTTATC -> ACTTTAAAAAAGTTTATCT
CAGAAGTGGCTACTTCTCC -> AGAAGTGGCTACTTCTCCG
CAGACCGGTGAGTCCACTG -> AGACCGGTGAGTCCACTGA
CAGACCTGGTTGTTGCTGA -> AGACCTGGTTGTTGCTGAA
CAGACGACATGTTGATTTG -> AGACGACATGTTGATTTGC
CAGACGACCATTGCGCGTG -> AGACGACCATTGCGCGTGC
CAGACGACGAAATGTCGTT -> AGACGACGAAATGTCGTTC
CAGACGACTGATTCCTTAC -> AGACGACTGATTCCTTACC
CAGAGCACATGGCCACAAG -> AGAGCACATGGCCACAAGT
CAGAGGAATATAAACTCCG -> AGAGGAATATAAACTCCGG
CAGAGGACTCGCCGACAAA -> AGAGGACTCGCCGACAAAA
CAGAGGAGACGGTTACACT -> AGAGGAGACGGTTACACTA
CAGAGTACTCATAACACTG -> AGAGTACTCATAACACTGA
CAGATGACTATGACAGGTC -> AGATGACTATGACAGGTCC
CAGATGTCGCCGTGTGTAG -> AGATGTCGCCGTGTGTAGC
CAGCAGGAGGCAAGGTCAG -> AGCAGGAGGCAAGGTCAGA
CAGCCAATAAACATGTGAT -> AGCCAATAAACATGTGATG
CAGCCTTGGTCTTCATGGA -> AGCCTTGGTCTTCATGGAT
CAGCGATGCTCCGACCACT -> AGCGATGCTCCGACCACTT
CAGCGCAACCAATTTCCCG -> AGCGCAACCAATTTCCCGT
CAGGAACCAGTCCACATAG -> AGGAACCAGTCCACATAGT
CAGGAGATCTTTCTTTGTC -> AGGAGATCTTTCTTTGTCA
CAGGAGGCAAGGTCAGATG -> AGGAGGCAAGGTCAGATGT
CAGGGAATGGTTAGGGTGT -> AGGGAATGGTTAGGGTGTT
CAGGGTTCGTCTGACCCAA -> AGGGTTCGTCTGACCCAAG
CAGGGTTCGTCTGACGCTC -> AGGGTTCGTCTGACGCTCT
CAGGGTTCGTCTGACGGTG -> AGGGTTCGTCTGACGGTGG
CAGGGTTCGTCTGACTCGC -> AGGGTTCGTCTGACTCGCC
CAGGTCCCAGAAGTGGCTA -> AGGTCCCAGAAGTGGCTAC
CAGGTGGACATCGATGGTG -> AGGTGGACATCGATGGTGC
CAGGTGTCCTTATGGAATC -> AGGTGTCCTTATGGAATCG
CAGTCCACATAGTCAATTG -> AGTCCACATAGTCAATTGT
CAGTCCTGTACGGTAAACA -> AGTCCTGTACGGTAAACAT
CAGTGAGATTTGGCCTCTG -> AGTGAGATTTGGCCTCTGG
CATAACACGCTACCAGACC -> ATAACACGCTACCAGACCT
CATAACACTGATGGATGCG -> ATAACACTGATGGATGCGA
CATACGGGCACTGCTCAGA -> ATACGGGCACTGCTCAGAG
CATACGTCGACTTCAGACG -> ATACGTCGACTTCAGACGA
CATAGTCAATTGTTTACCA -> ATAGTCAATTGTTTACCAT
CATATAATTCAGGTGTCCT -> ATATAATTCAGGTGTCCTT
CATATATGAAATCGCTTTT -> ATATATGAAATCGCTTTTG
CATATGATTTTCGTGACAG -> ATATGATTTTCGTGACAGT
CATATTCACTGCATTTATG -> ATATTCACTGCATTTATGT
CATCACTCCGAATTACACA -> ATCACTCCGAATTACACAC
CATCAGGAACCAGTCCACA -> ATCAGGAACCAGTCCACAT
CATCCCAATGTAATCAACG -> ATCCCAATGTAATCAACGT
CATCCGATGAGCAAGATAA -> ATCCGATGAGCAAGATAAC
CATCCGGATTCGATCTTAT -> ATCCGGATTCGATCTTATT
CATCGAACAAAGGAACTAA -> ATCGAACAAAGGAACTAAT
CATCGACAATCTCAGAGGA -> ATCGACAATCTCAGAGGAG
CATCGATGGTGCCCGCTGA -> ATCGATGGTGCCCGCTGAT
CATCGTAGGCACTTGAGTG -> ATCGTAGGCACTTGAGTGG
CATCTGAGGATGCGACGCG -> ATCTGAGGATGCGACGCGA
CATCTGGAGCGGGAGTACT -> ATCTGGAGCGGGAGTACTG
CATGGAATACTTAAACAAA -> ATGGAATACTTAAACAAAT
CATGGATTGTCTGGTTCTG -> ATGGATTGTCTGGTTCTGT
CATGGCCACAAGTGCGAGG -> ATGGCCACAAGTGCGAGGG
CATGGCCATGGAATACTTA -> ATGGCCATGGAATACTTAA
CATGGCCGCATTCGCAACC -> ATGGCCGCATTCGCAACCC
CATGGGCGTATAGGGGGGA -> ATGGGCGTATAGGGGGGAG
CATGGGGAACGGCAATCTA -> ATGGGGAACGGCAATCTAG
CATGTGATGTTTCTTTAAT -> ATGTGATGTTTCTTTAATA
CATGTTGATTTGCCGCCAG -> ATGTTGATTTGCCGCCAGG
CATTAGCAATAAATAATTT -> ATTAGCAATAAATAATTTT
CATTATCATTAGCAATAAA -> ATTATCATTAGCAATAAAT
CATTCGCAACCCACGGCGG -> ATTCGCAACCCACGGCGGA
CATTCGTCTCCAATACCTA -> ATTCGTCTCCAATACCTAC
CATTGCGCGTGCCGCCAGG -> ATTGCGCGTGCCGCCAGGG
CATTGGAGAGTAGAAGAAA -> ATTGGAGAGTAGAAGAAAG
CATTGGTCCGACAACCGAC -> ATTGGTCCGACAACCGACA
CATTTATGTATGGTTTAAA -> ATTTATGTATGGTTTAAAA
CATTTTCTGTATGCAAAGA -> ATTTTCTGTATGCAAAGAA
CCAAAAAGCTGGGCCTAAC -> CAAAAAGCTGGGCCTAACG
CCAAAAGGCGGTCGGACCC -> CAAAAGGCGGTCGGACCCT
CCAAATACTAGACTCGGGG -> CAAATACTAGACTCGGGGG
CCAAATAGTTCAAATGGGT -> CAAATAGTTCAAATGGGTC
CCAAGATGGCGCTTGCGGA -> CAAGATGGCGCTTGCGGAA
CCAATAAACATGTGATGTT -> CAATAAACATGTGATGTTT
CCAATACCTACTCTTCGCC -> CAATACCTACTCTTCGCCG
CCAATCACTTGGCGACAAT -> CAATCACTTGGCGACAATT
CCAATGGGGGACCGATCGG -> CAATGGGGGACCGATCGGC
CCAATGTAATCAACGTCGA -> CAATGTAATCAACGTCGAC
CCAATTTCCCGTACATATT -> CAATTTCCCGTACATATTC
CCACAAGTGCGAGGGCAAC -> CACAAGTGCGAGGGCAACC
CCACACGAAGTATGGAGCG -> CACACGAAGTATGGAGCGG
CCACATAGTCAATTGTTTA -> CACATAGTCAATTGTTTAC
CCACCATCCCAATGTAATC -> CACCATCCCAATGTAATCA
CCACCGAGTTACAGCCAAT -> CACCGAGTTACAGCCAATA
CCACCGTTCCGGGTACAAA -> CACCGTTCCGGGTACAAAT
CCACGGCGGACGGGATAGA -> CACGGCGGACGGGATAGAG
CCACTAAGTCCACTAGCTA -> CACTAAGTCCACTAGCTAT
CCACTAGCTATATCTGCGC -> CACTAGCTATATCTGCGCA
CCACTGAATAGAACCTAAA -> CACTGAATAGAACCTAAAT
CCACTTTAAAAAAGTTTAT -> CACTTTAAAAAAGTTTATC
CCAGAAGTGGCTACTTCTC -> CAGAAGTGGCTACTTCTCC
CCAGACCGGTGAGTCCACT -> CAGACCGGTGAGTCCACTG
CCAGACCTGGTTGTTGCTG -> CAGACCTGGTTGTTGCTGA
CCAGAGTACTCATAACACT -> CAGAGTACTCATAACACTG
CCAGATGACTATGACAGGT -> CAGATGACTATGACAGGTC
CCAGGGTTCGTCTGACCCA -> CAGGGTTCGTCTGACCCAA
CCAGGGTTCGTCTGACGCT -> CAGGGTTCGTCTGACGCTC
CCAGGGTTCGTCTGACGGT -> CAGGGTTCGTCTGACGGTG
CCAGGGTTCGTCTGACTCG -> CAGGGTTCGTCTGACTCGC
CCAGTCCACATAGTCAATT -> CAGTCCACATAGTCAATTG
CCAGTGAGATTTGGCCTCT -> CAGTGAGATTTGGCCTCTG
CCATACGGGCACTGCTCAG -> CATACGGGCACTGCTCAGA
CCATCACTCCGAATTACAC -> CATCACTCCGAATTACACA
CCATCCCAATGTAATCAAC -> CATCCCAATGTAATCAACG
CCATCTGAGGATGCGACGC -> CATCTGAGGATGCGACGCG
CCATCTGGAGCGGGAGTAC -> CATCTGGAGCGGGAGTACT
CCATGGAATACTTAAACAA -> CATGGAATACTTAAACAAA
CCATGGGCGTATAGGGGGG -> CATGGGCGTATAGGGGGGA
CCATTGCGCGTGCCGCCAG -> CATTGCGCGTGCCGCCAGG
CCATTGGTCCGACAACCGA -> CATTGGTCCGACAACCGAC
CCCAAGATGGCGCTTGCGG -> CCAAGATGGCGCTTGCGGA
CCCAATGGGGGACCGATCG -> CCAATGGGGGACCGATCGG
CCCAATGTAATCAACGTCG -> CCAATGTAATCAACGTCGA
CCCACCATCCCAATGTAAT -> CCACCATCCCAATGTAATC
CCCACGGCGGACGGGATAG -> CCACGGCGGACGGGATAGA
CCCACTAAGTCCACTAGCT -> CCACTAAGTCCACTAGCTA
CCCAGAAGTGGCTACTTCT -> CCAGAAGTGGCTACTTCTC
CCCAGATGACTATGACAGG -> CCAGATGACTATGACAGGT
CCCAGTGAGATTTGGCCTC -> CCAGTGAGATTTGGCCTCT
CCCATACGGGCACTGCTCA -> CCATACGGGCACTGCTCAG
CCCATTGGTCCGACAACCG -> CCATTGGTCCGACAACCGA
CCCGCCAGGGTTCGTCTGA -> CCGCCAGGGTTCGTCTGAC
CCCGCTGATGCTCATAACA -> CCGCTGATGCTCATAACAC
CCCGGAAACTTCAGCAGGA -> CCGGAAACTTCAGCAGGAG
CCCGGCAGCGATGCTCCGA -> CCGGCAGCGATGCTCCGAC
CCCGGGATATGCGGCGCTG -> CCGGGATATGCGGCGCTGA
CCCGTACATATTCACTGCA -> CCGTACATATTCACTGCAT
CCCTCGTCGGTACATGGGG -> CCTCGTCGGTACATGGGGA
CCCTTTAATCGGTCAGCCT -> CCTTTAATCGGTCAGCCTT
CCGAAACCGGCGTTGAACA -> CGAAACCGGCGTTGAACAA
CCGAATTACACACAACATG -> CGAATTACACACAACATGG
CCGACAAAATAATAACATA -> CGACAAAATAATAACATAT
CCGACAACCGACAATTTGC -> CGACAACCGACAATTTGCA
CCGACAATTTGCATCGAAC -> CGACAATTTGCATCGAACA
CCGACCACTTTAAAAAAGT -> CGACCACTTTAAAAAAGTT
CCGACTCATCGACAATCTC -> CGACTCATCGACAATCTCA
CCGAGTTACAGCCAATAAA -> CGAGTTACAGCCAATAAAC
CCGATCGGCTAGCTGCACA -> CGATCGGCTAGCTGCACAT
CCGATGAGCAAGATAACTG -> CGATGAGCAAGATAACTGC
CCGCATTCGCAACCCACGG -> CGCATTCGCAACCCACGGC
CCGCCAGACCGGTGAGTCC -> CGCCAGACCGGTGAGTCCA
CCGCCAGGGTTCGTCTGAC -> CGCCAGGGTTCGTCTGACC,CGCCAGGGTTCGTCTGACG,CGCCAGGGTTCGTCTGACG,CGCCAGGGTTCGTCTGACT
CCGCGTGAGCCCACTAAGT -> CGCGTGAGCCCACTAAGTC
CCGCTCATCCGATGAGCAA -> CGCTCATCCGATGAGCAAG
CCGCTGATGCTCATAACAC -> CGCTGATGCTCATAACACG
CCGGAAACTTCAGCAGGAG -> CGGAAACTTCAGCAGGAGG
CCGGATTCGATCTTATTTT -> CGGATTCGATCTTATTTTG
CCGGCAGCGATGCTCCGAC -> CGGCAGCGATGCTCCGACC
CCGGCGTTGAACAACGAAT -> CGGCGTTGAACAACGAATC
CCGGCTCAATCACTAATAC -> CGGCTCAATCACTAATACC
CCGGGAAGGGCCTATCCGG -> CGGGAAGGGCCTATCCGGC
CCGGGATATGCGGCGCTGA -> CGGGATATGCGGCGCTGAT
CCGGGTACAAATCCAAATA -> CGGGTACAAATCCAAATAG
CCGGTCACCATCTGGAGCG -> CGGTCACCATCTGGAGCGG
CCGGTGAGTCCACTGAATA -> CGGTGAGTCCACTGAATAG
CCGGTTCTAGTCTAGAATC -> CGGTTCTAGTCTAGAATCT
CCGGTTTTTTGCCCTTTAA -> CGGTTTTTTGCCCTTTAAT
CCGTACATATTCACTGCAT -> CGTACATATTCACTGCATT
CCGTAGGTTGATGGCATCC -> CGTAGGTTGATGGCATCCG
CCGTGATGATGGACTACAT -> CGTGATGATGGACTACATG
CCGTGCGAAATGTATCTCA -> CGTGCGAAATGTATCTCAC
CCGTGGCCACCGTTCCGGG -> CGTGGCCACCGTTCCGGGT
CCGTGTGTAGCACGCTCAT -> CGTGTGTAGCACGCTCATT
CCGTTCCGGGTACAAATCC -> CGTTCCGGGTACAAATCCA
CCTAAATGTCTGACCAGAG -> CTAAATGTCTGACCAGAGT
CCTAACGACCGCGTGAGCC -> CTAACGACCGCGTGAGCCC
CCTACTCTTCGCCGGGAAG -> CTACTCTTCGCCGGGAAGG
CCTAGGCAAACCTGGGACA -> CTAGGCAAACCTGGGACAC
CCTATCCGGCTCAATCACT -> CTATCCGGCTCAATCACTA
CCTCCACACGAAGTATGGA -> CTCCACACGAAGTATGGAG
CCTCGTCGGTACATGGGGA -> CTCGTCGGTACATGGGGAA
CCTCTGGAACTAGACCCAT -> CTCTGGAACTAGACCCATT
CCTGGGACACGAGTATGAT -> CTGGGACACGAGTATGATA
CCTGGTTGTTGCTGAAAGG -> CTGGTTGTTGCTGAAAGGC
CCTGTACGGTAAACATCAG -> CTGTACGGTAAACATCAGG
CCTTACCCGCCAGGGTTCG -> CTTACCCGCCAGGGTTCGT
CCTTATGGAATCGGATCAC -> CTTATGGAATCGGATCACT
CCTTCTTGCTCAGAGGACT -> CTTCTTGCTCAGAGGACTC
CCTTGCCATCACTCCGAAT -> CTTGCCATCACTCCGAATT
CCTTGGTCTTCATGGATTG -> CTTGGTCTTCATGGATTGT
CCTTTAATCGGTCAGCCTT -> CTTTAATCGGTCAGCCTTG
CGAAACCGGCGTTGAACAA -> GAAACCGGCGTTGAACAAC
CGAAATGTATCTCACGTAA -> GAAATGTATCTCACGTAAA
CGAAATGTCGTTCCGCCAG -> GAAATGTCGTTCCGCCAGG
CGAACAAAGGAACTAATAG -> GAACAAAGGAACTAATAGA
CGAACCCGGCAGCGATGCT -> GAACCCGGCAGCGATGCTC
CGAAGTATGGAGCGGTCAA -> GAAGTATGGAGCGGTCAAC
CGAATCTTCTCATATGATT -> GAATCTTCTCATATGATTT
CGAATTACACACAACATGG -> GAATTACACACAACATGGC
CGACAAAATAATAACATAT -> GACAAAATAATAACATATA
CGACAACCGACAATTTGCA -> GACAACCGACAATTTGCAT
CGACAATCTCAGAGGAGAC -> GACAATCTCAGAGGAGACG
CGACAATTACCAAAAAGCT -> GACAATTACCAAAAAGCTG
CGACAATTTGCATCGAACA -> GACAATTTGCATCGAACAA
CGACATGTTGATTTGCCGC -> GACATGTTGATTTGCCGCC
CGACCACTTTAAAAAAGTT -> GACCACTTTAAAAAAGTTT
CGACCATTGCGCGTGCCGC -> GACCATTGCGCGTGCCGCC
CGACCGCGTGAGCCCACTA -> GACCGCGTGAGCCCACTAA
CGACGAAATGTCGTTCCGC -> GACGAAATGTCGTTCCGCC
CGACGCGAGATACGCCCAG -> GACGCGAGATACGCCCAGA
CGACTCATCGACAATCTCA -> GACTCATCGACAATCTCAG
CGACTCTCCCGGGATATGC -> GACTCTCCCGGGATATGCG
CGACTGATTCCTTACCCGC -> GACTGATTCCTTACCCGCC
CGACTTCAGACGACATGTT -> GACTTCAGACGACATGTTG
CGACTTCAGACGACCATTG -> GACTTCAGACGACCATTGC
CGACTTCAGACGACGAAAT -> GACTTCAGACGACGAAATG
CGACTTCAGACGACTGATT -> GACTTCAGACGACTGATTC
CGAGATACGCCCAGATGAC -> GAGATACGCCCAGATGACT
CGAGCCGGTTCTAGTCTAG -> GAGCCGGTTCTAGTCTAGA
CGAGGGCAACCGAAACCGG -> GAGGGCAACCGAAACCGGC
CGAGTAGGGGCCTCCACAC -> GAGTAGGGGCCTCCACACG
CGAGTATGATACATTTTCT -> GAGTATGATACATTTTCTG
CGAGTTACAGCCAATAAAC -> GAGTTACAGCCAATAAACA
CGAGTTGAAAAAAGCCCAT -> GAGTTGAAAAAAGCCCATA
CGATCGGCTAGCTGCACAT -> GATCGGCTAGCTGCACATA
CGATCTTATTTTGAAGGGC -> GATCTTATTTTGAAGGGCC
CGATGACGGTACAGGAGAT -> GATGACGGTACAGGAGATC
CGATGAGCAAGATAACTGC -> GATGAGCAAGATAACTGCT
CGATGCTCCGACCACTTTA -> GATGCTCCGACCACTTTAA
CGATGGTGCCCGCTGATGC -> GATGGTGCCCGCTGATGCT
CGCAACCAATTTCCCGTAC -> GCAACCAATTTCCCGTACA
CGCAACCCACGGCGGACGG -> GCAACCCACGGCGGACGGG
CGCACTACGAGTAGGGGCC -> GCACTACGAGTAGGGGCCT
CGCACTGAGTGAATGCGAT -> GCACTGAGTGAATGCGATG
CGCAGCGCAACCAATTTCC -> GCAGCGCAACCAATTTCCC
CGCATTATCATTAGCAATA -> GCATTATCATTAGCAATAA
CGCATTCGCAACCCACGGC -> GCATTCGCAACCCACGGCG
CGCCAGACCGGTGAGTCCA -> GCCAGACCGGTGAGTCCAC
CGCCAGGGTTCGTCTGACC -> GCCAGGGTTCGTCTGACCC
CGCCAGGGTTCGTCTGACG -> GCCAGGGTTCGTCTGACGC,GCCAGGGTTCGTCTGACGG
CGCCAGGGTTCGTCTGACT -> GCCAGGGTTCGTCTGACTC
CGCCCAGATGACTATGACA -> GCCCAGATGACTATGACAG
CGCCGACAAAATAATAACA -> GCCGACAAAATAATAACAT
CGCCGGGAAGGGCCTATCC -> GCCGGGAAGGGCCTATCCG
CGCCGTGTGTAGCACGCTC -> GCCGTGTGTAGCACGCTCA
CGCCTAGGCAAACCTGGGA -> GCCTAGGCAAACCTGGGAC
CGCGAGATACGCCCAGATG -> GCGAGATACGCCCAGATGA
CGCGTATGTCACACTATCG -> GCGTATGTCACACTATCGC
CGCGTGAGCCCACTAAGTC -> GCGTGAGCCCACTAAGTCC
CGCGTGCCGCCAGGGTTCG -> GCGTGCCGCCAGGGTTCGT
CGCTACCAGACCTGGTTGT -> GCTACCAGACCTGGTTGTT
CGCTCATCCGATGAGCAAG -> GCTCATCCGATGAGCAAGA
CGCTCATTGGAGAGTAGAA -> GCTCATTGGAGAGTAGAAG
CGCTCTTAGGTTATGCCGC -> GCTCTTAGGTTATGCCGCC
CGCTGATCCTTGCCATCAC -> GCTGATCCTTGCCATCACT
CGCTGATGCTCATAACACG -> GCTGATGCTCATAACACGC
CGCTTGCGGAAACTCATCG -> GCTTGCGGAAACTCATCGT
CGCTTTTGTTAATGGGACT -> GCTTTTGTTAATGGGACTC
CGGAAACTCATCGTAGGCA -> GGAAACTCATCGTAGGCAC
CGGAAACTTCAGCAGGAGG -> GGAAACTTCAGCAGGAGGC
CGGACCCTCGTCGGTACAT -> GGACCCTCGTCGGTACATG
CGGACGGGATAGAGTCTCG -> GGACGGGATAGAGTCTCGC
CGGATCACTAGTTTCACCC -> GGATCACTAGTTTCACCCA
CGGATTCGATCTTATTTTG -> GGATTCGATCTTATTTTGA
CGGCAATCTAGCCGTAGGT -> GGCAATCTAGCCGTAGGTT
CGGCAGCGATGCTCCGACC -> GGCAGCGATGCTCCGACCA
CGGCGCTGATCCTTGCCAT -> GGCGCTGATCCTTGCCATC
CGGCGGACGGGATAGAGTC -> GGCGGACGGGATAGAGTCT
CGGCGTTGAACAACGAATC -> GGCGTTGAACAACGAATCT
CGGCTAGCTGCACATATAA -> GGCTAGCTGCACATATAAT
CGGCTCAATCACTAATACC -> GGCTCAATCACTAATACCA
CGGGAAGGGCCTATCCGGC -> GGGAAGGGCCTATCCGGCT
CGGGAGTACTGCTACTGAT -> GGGAGTACTGCTACTGATC
CGGGATAGAGTCTCGCACT -> GGGATAGAGTCTCGCACTA
CGGGATATGCGGCGCTGAT -> GGGATATGCGGCGCTGATC
CGGGCACTGCTCAGAGGAA -> GGGCACTGCTCAGAGGAAT
CGGGCCGTGCGAAATGTAT -> GGGCCGTGCGAAATGTATC
CGGGGGAGTTCCGTGGCCA -> GGGGGAGTTCCGTGGCCAC
CGGGTACAAATCCAAATAG -> GGGTACAAATCCAAATAGT
CGGTAAACATCAGGAACCA -> GGTAAACATCAGGAACCAG
CGGTACAGGAGATCTTTCT -> GGTACAGGAGATCTTTCTT
CGGTACATGGGGAACGGCA -> GGTACATGGGGAACGGCAA
CGGTCAACAGGGAATGGTT -> GGTCAACAGGGAATGGTTA
CGGTCACCATCTGGAGCGG -> GGTCACCATCTGGAGCGGG
CGGTCAGCCTTGGTCTTCA -> GGTCAGCCTTGGTCTTCAT
CGGTCGGACCCTCGTCGGT -> GGTCGGACCCTCGTCGGTA
CGGTGAGTCCACTGAATAG -> GGTGAGTCCACTGAATAGA
CGGTGGGTTCATACGTCGA -> GGTGGGTTCATACGTCGAC
CGGTTACACTATTGGAAGT -> GGTTACACTATTGGAAGTG
CGGTTCTAGTCTAGAATCT -> GGTTCTAGTCTAGAATCTC
CGGTTGCACCAAATACTAG -> GGTTGCACCAAATACTAGA
CGGTTTTTTGCCCTTTAAT -> GGTTTTTTGCCCTTTAATC
CGTAAATGAGACTATAACA -> GTAAATGAGACTATAACAA
CGTACATATTCACTGCATT -> GTACATATTCACTGCATTT
CGTAGGCACTTGAGTGGAG -> GTAGGCACTTGAGTGGAGG
CGTAGGTTGATGGCATCCG -> GTAGGTTGATGGCATCCGG
CGTATAACCCACCATCCCA -> GTATAACCCACCATCCCAA
CGTATAGGGGGGAGTTGCA -> GTATAGGGGGGAGTTGCAC
CGTATGGCCGGTCACCATC -> GTATGGCCGGTCACCATCT
CGTATGTCACACTATCGCA -> GTATGTCACACTATCGCAT
CGTCGACTTCAGACGACAT -> GTCGACTTCAGACGACATG
CGTCGACTTCAGACGACCA -> GTCGACTTCAGACGACCAT
CGTCGACTTCAGACGACGA -> GTCGACTTCAGACGACGAA
CGTCGACTTCAGACGACTG -> GTCGACTTCAGACGACTGA
CGTCGGTACATGGGGAACG -> GTCGGTACATGGGGAACGG
CGTCTCCAATACCTACTCT -> GTCTCCAATACCTACTCTT
CGTCTGACCCAAGATGGCG -> GTCTGACCCAAGATGGCGC
CGTCTGACGCTCTTAGGTT -> GTCTGACGCTCTTAGGTTA
CGTCTGACGGTGGGTTCAT -> GTCTGACGGTGGGTTCATA
CGTCTGACTCGCCTAGGCA -> GTCTGACTCGCCTAGGCAA
CGTGACAGTCCTGTACGGT -> GTGACAGTCCTGTACGGTA
CGTGAGCCCACTAAGTCCA -> GTGAGCCCACTAAGTCCAC
CGTGATGATGGACTACATG -> GTGATGATGGACTACATGG
CGTGCCGCCAGGGTTCGTC -> GTGCCGCCAGGGTTCGTCT
CGTGCGAAATGTATCTCAC -> GTGCGAAATGTATCTCACG
CGTGGCCACCGTTCCGGGT -> GTGGCCACCGTTCCGGGTA
CGTGTCGCACTGAGTGAAT -> GTGTCGCACTGAGTGAATG
CGTGTGTAGCACGCTCATT -> GTGTGTAGCACGCTCATTG
CGTTCCGCCAGGGTTCGTC -> GTTCCGCCAGGGTTCGTCT
CGTTCCGGGTACAAATCCA -> GTTCCGGGTACAAATCCAA
CGTTGAACAACGAATCTTC -> GTTGAACAACGAATCTTCT
CGTTTGAGGCTGTACTGTG -> GTTTGAGGCTGTACTGTGG
CTAAATGTCTGACCAGAGT -> TAAATGTCTGACCAGAGTA
CTAACGACCGCGTGAGCCC -> TAACGACCGCGTGAGCCCA
CTAAGTCCACTAGCTATAT -> TAAGTCCACTAGCTATATC
CTAATACCAATCACTTGGC -> TAATACCAATCACTTGGCG
CTAATAGAGAAGGTAGGAC -> TAATAGAGAAGGTAGGACG
CTAATCCACCGAGTTACAG -> TAATCCACCGAGTTACAGC
CTACAGGTGGACATCGATG -> TACAGGTGGACATCGATGG
CTACATGGCCATGGAATAC -> TACATGGCCATGGAATACT
CTACCAGACCTGGTTGTTG -> TACCAGACCTGGTTGTTGC
CTACGAGTAGGGGCCTCCA -> TACGAGTAGGGGCCTCCAC
CTACTCTTCGCCGGGAAGG -> TACTCTTCGCCGGGAAGGG
CTACTGATCGAGCCGGTTC -> TACTGATCGAGCCGGTTCT
CTACTTCTCCGACTCATCG -> TACTTCTCCGACTCATCGA
CTAGAATCTCCTTCTTGCT -> TAGAATCTCCTTCTTGCTC
CTAGACCCATTGGTCCGAC -> TAGACCCATTGGTCCGACA
CTAGACTCGGGGGAGTTCC -> TAGACTCGGGGGAGTTCCG
CTAGATTTGCACGTCGACT -> TAGATTTGCACGTCGACTT
CTAGCCGTAGGTTGATGGC -> TAGCCGTAGGTTGATGGCA
CTAGCTATATCTGCGCAGC -> TAGCTATATCTGCGCAGCG
CTAGCTGCACATATAATTC -> TAGCTGCACATATAATTCA
CTAGGCAAACCTGGGACAC -> TAGGCAAACCTGGGACACG
CTAGTAGCTACAGGTGGAC -> TAGTAGCTACAGGTGGACA
CTAGTCTAGAATCTCCTTC -> TAGTCTAGAATCTCCTTCT
CTAGTTTCACCCAGTGAGA -> TAGTTTCACCCAGTGAGAT
CTATAACAAGCTTTCAAGC -> TATAACAAGCTTTCAAGCA
CTATAGGTATCCGTGATGA -> TATAGGTATCCGTGATGAT
CTATATCTGCGCAGCGCAA -> TATATCTGCGCAGCGCAAC
CTATCCGGCTCAATCACTA -> TATCCGGCTCAATCACTAA
CTATCGCATTATCATTAGC -> TATCGCATTATCATTAGCA
CTATGACAGGTCCCAGAAG -> TATGACAGGTCCCAGAAGT
CTATTGGAAGTGTTTGACA -> TATTGGAAGTGTTTGACAC
CTCAATCACTAATACCAAT -> TCAATCACTAATACCAATC
CTCACGTAAATGAGACTAT -> TCACGTAAATGAGACTATA
CTCAGAGGAATATAAACTC -> TCAGAGGAATATAAACTCC
CTCAGAGGACTCGCCGACA -> TCAGAGGACTCGCCGACAA
CTCAGAGGAGACGGTTACA -> TCAGAGGAGACGGTTACAC
CTCATAACACGCTACCAGA -> TCATAACACGCTACCAGAC
CTCATAACACTGATGGATG -> TCATAACACTGATGGATGC
CTCATATGATTTTCGTGAC -> TCATATGATTTTCGTGACA
CTCATCCGATGAGCAAGAT -> TCATCCGATGAGCAAGATA
CTCATCGACAATCTCAGAG -> TCATCGACAATCTCAGAGG
CTCATCGTAGGCACTTGAG -> TCATCGTAGGCACTTGAGT
CTCATTGGAGAGTAGAAGA -> TCATTGGAGAGTAGAAGAA
CTCCAATACCTACTCTTCG -> TCCAATACCTACTCTTCGC
CTCCACACGAAGTATGGAG -> TCCACACGAAGTATGGAGC
CTCCCGGAAACTTCAGCAG -> TCCCGGAAACTTCAGCAGG
CTCCCGGGATATGCGGCGC -> TCCCGGGATATGCGGCGCT
CTCCGAATTACACACAACA -> TCCGAATTACACACAACAT
CTCCGACCACTTTAAAAAA -> TCCGACCACTTTAAAAAAG
CTCCGACTCATCGACAATC -> TCCGACTCATCGACAATCT
CTCCGGTTTTTTGCCCTTT -> TCCGGTTTTTTGCCCTTTA
CTCCTTCTTGCTCAGAGGA -> TCCTTCTTGCTCAGAGGAC
CTCGCACTACGAGTAGGGG -> TCGCACTACGAGTAGGGGC
CTCGCCGACAAAATAATAA -> TCGCCGACAAAATAATAAC
CTCGCCTAGGCAAACCTGG -> TCGCCTAGGCAAACCTGGG
CTCGGGGGAGTTCCGTGGC -> TCGGGGGAGTTCCGTGGCC
CTCGTCGGTACATGGGGAA -> TCGTCGGTACATGGGGAAC
CTCTCCCGGGATATGCGGC -> TCTCCCGGGATATGCGGCG
CTCTGGAACTAGACCCATT -> TCTGGAACTAGACCCATTG
CTCTTAGGTTATGCCGCCA -> TCTTAGGTTATGCCGCCAG
CTCTTCGCCGGGAAGGGCC -> TCTTCGCCGGGAAGGGCCT
CTGAAAGGCGGGCCGTGCG -> TGAAAGGCGGGCCGTGCGA
CTGAATAGAACCTAAATGT -> TGAATAGAACCTAAATGTC
CTGACCAGAGTACTCATAA -> TGACCAGAGTACTCATAAC
CTGACCCAAGATGGCGCTT -> TGACCCAAGATGGCGCTTG
CTGACGCTCTTAGGTTATG -> TGACGCTCTTAGGTTATGC
CTGACGGTGGGTTCATACG -> TGACGGTGGGTTCATACGT
CTGACTCGCCTAGGCAAAC -> TGACTCGCCTAGGCAAACC
CTGAGAGTTGGGGTGGCAG -> TGAGAGTTGGGGTGGCAGA
CTGAGGATGCGACGCGAGA -> TGAGGATGCGACGCGAGAT
CTGAGTGAATGCGATGACG -> TGAGTGAATGCGATGACGG
CTGATCCTTGCCATCACTC -> TGATCCTTGCCATCACTCC
CTGATCGAGCCGGTTCTAG -> TGATCGAGCCGGTTCTAGT
CTGATGCTCATAACACGCT -> TGATGCTCATAACACGCTA
CTGATGGATGCGACTCTCC -> TGATGGATGCGACTCTCCC
CTGATTCCTTACCCGCCAG -> TGATTCCTTACCCGCCAGG
CTGCAACGTGTCGCACTGA -> TGCAACGTGTCGCACTGAG
CTGCACATATAATTCAGGT -> TGCACATATAATTCAGGTG
CTGCATTTATGTATGGTTT -> TGCATTTATGTATGGTTTA
CTGCGCAGCGCAACCAATT -> TGCGCAGCGCAACCAATTT
CTGCTACTGATCGAGCCGG -> TGCTACTGATCGAGCCGGT
CTGCTAGTAGCTACAGGTG -> TGCTAGTAGCTACAGGTGG
CTGCTCAGAGGAATATAAA -> TGCTCAGAGGAATATAAAC
CTGGAACTAGACCCATTGG -> TGGAACTAGACCCATTGGT
CTGGAGCGGGAGTACTGCT -> TGGAGCGGGAGTACTGCTA
CTGGATAGCTAATCCACCG -> TGGATAGCTAATCCACCGA
CTGGGACACGAGTATGATA -> TGGGACACGAGTATGATAC
CTGGGCCTAACGACCGCGT -> TGGGCCTAACGACCGCGTG
CTGGTTGTTGCTGAAAGGC -> TGGTTGTTGCTGAAAGGCG
CTGTACGGTAAACATCAGG -> TGTACGGTAAACATCAGGA
CTGTACTGTGGGAAATTGT -> TGTACTGTGGGAAATTGTG
CTGTATGCAAAGAACGAAC -> TGTATGCAAAGAACGAACC
CTGTGAGTTATGACGTATA -> TGTGAGTTATGACGTATAA
CTGTGGGAAATTGTGGTTA -> TGTGGGAAATTGTGGTTAG
CTTAAACAAATTTGGCGAG -> TTAAACAAATTTGGCGAGT
CTTACCCGCCAGGGTTCGT -> TTACCCGCCAGGGTTCGTC
CTTAGGTTATGCCGCCAGA -> TTAGGTTATGCCGCCAGAC
CTTATGGAATCGGATCACT -> TTATGGAATCGGATCACTA
CTTATTTTGAAGGGCCGCT -> TTATTTTGAAGGGCCGCTC
CTTCAGACGACATGTTGAT -> TTCAGACGACATGTTGATT
CTTCAGACGACCATTGCGC -> TTCAGACGACCATTGCGCG
CTTCAGACGACGAAATGTC -> TTCAGACGACGAAATGTCG
CTTCAGACGACTGATTCCT -> TTCAGACGACTGATTCCTT
CTTCAGCAGGAGGCAAGGT -> TTCAGCAGGAGGCAAGGTC
CTTCATGGATTGTCTGGTT -> TTCATGGATTGTCTGGTTC
CTTCGCCGGGAAGGGCCTA -> TTCGCCGGGAAGGGCCTAT
CTTCTCATATGATTTTCGT -> TTCTCATATGATTTTCGTG
CTTCTCCGACTCATCGACA -> TTCTCCGACTCATCGACAA
CTTCTTGCTCAGAGGACTC -> TTCTTGCTCAGAGGACTCG
CTTGAGTGGAGGAAAAAAC -> TTGAGTGGAGGAAAAAACC
CTTGCCATCACTCCGAATT -> TTGCCATCACTCCGAATTA
CTTGCGGAAACTCATCGTA -> TTGCGGAAACTCATCGTAG
CTTGCTCAGAGGACTCGCC -> TTGCTCAGAGGACTCGCCG
CTTGGCGACAATTACCAAA -> TTGGCGACAATTACCAAAA
CTTGGTCTTCATGGATTGT -> TTGGTCTTCATGGATTGTC
CTTTAAAAAAGTTTATCTG -> TTTAAAAAAGTTTATCTGT
CTTTAATAAACGCGTATGT -> TTTAATAAACGCGTATGTC
CTTTAATCGGTCAGCCTTG -> TTTAATCGGTCAGCCTTGG
CTTTCAAGCATTCGTCTCC -> TTTCAAGCATTCGTCTCCA
CTTTCTTTGTCACGTATGG -> TTTCTTTGTCACGTATGGC
CTTTGTCACGTATGGCCGG -> TTTGTCACGTATGGCCGGT
CTTTTGTTAATGGGACTCC -> TTTTGTTAATGGGACTCCC
GAAAAAACCATCTGAGGAT -> AAAAAACCATCTGAGGATG
GAAAAAAGCCCATACGGGC -> AAAAAAGCCCATACGGGCA
GAAACCGGCGTTGAACAAC -> AAACCGGCGTTGAACAACG
GAAACTCATCGTAGGCACT -> AAACTCATCGTAGGCACTT
GAAACTTCAGCAGGAGGCA -> AAACTTCAGCAGGAGGCAA
GAAAGAGACTATAGGTATC -> AAAGAGACTATAGGTATCC
GAAAGGCGGGCCGTGCGAA -> AAAGGCGGGCCGTGCGAAA
GAAATCGCTTTTGTTAATG -> AAATCGCTTTTGTTAATGG
GAAATGGCTGCAACGTGTC -> AAATGGCTGCAACGTGTCG
GAAATGTATCTCACGTAAA -> AAATGTATCTCACGTAAAT
GAAATGTCGTTCCGCCAGG -> AAATGTCGTTCCGCCAGGG
GAAATTGTGGTTAGACTAG -> AAATTGTGGTTAGACTAGA
GAACAAAGGAACTAATAGA -> AACAAAGGAACTAATAGAG
GAACAACGAATCTTCTCAT -> AACAACGAATCTTCTCATA
GAACCAGTCCACATAGTCA -> AACCAGTCCACATAGTCAA
GAACCCGGCAGCGATGCTC -> AACCCGGCAGCGATGCTCC
GAACCTAAATGTCTGACCA -> AACCTAAATGTCTGACCAG
GAACGAACCCGGCAGCGAT -> AACGAACCCGGCAGCGATG
GAACGGCAATCTAGCCGTA -> AACGGCAATCTAGCCGTAG
GAACTAATAGAGAAGGTAG -> AACTAATAGAGAAGGTAGG
GAACTAGACCCATTGGTCC -> AACTAGACCCATTGGTCCG
GAAGAAAGAGACTATAGGT -> AAGAAAGAGACTATAGGTA
GAAGGGCCGCTCATCCGAT -> AAGGGCCGCTCATCCGATG
GAAGGGCCTATCCGGCTCA -> AAGGGCCTATCCGGCTCAA
GAAGGTAGGACGTCGACTT -> AAGGTAGGACGTCGACTTC
GAAGTATGGAGCGGTCAAC -> AAGTATGGAGCGGTCAACA
GAAGTGGCTACTTCTCCGA -> AAGTGGCTACTTCTCCGAC
GAAGTGTTTGACACCAAAA -> AAGTGTTTGACACCAAAAG
GAATACTTAAACAAATTTG -> AATACTTAAACAAATTTGG
GAATAGAACCTAAATGTCT -> AATAGAACCTAAATGTCTG
GAATATAAACTCCGGTTTT -> AATATAAACTCCGGTTTTT
GAATCGGATCACTAGTTTC -> AATCGGATCACTAGTTTCA
GAATCTCCTTCTTGCTCAG -> AATCTCCTTCTTGCTCAGA
GAATCTTCTCATATGATTT -> AATCTTCTCATATGATTTT
GAATGCGATGACGGTACAG -> AATGCGATGACGGTACAGG
GAATGGTTAGGGTGTTTGA -> AATGGTTAGGGTGTTTGAA
GAATTACACACAACATGGC -> AATTACACACAACATGGCC
GACAAAATAATAACATATA -> ACAAAATAATAACATATAT
GACAACCGACAATTTGCAT -> ACAACCGACAATTTGCATC
GACAATCTCAGAGGAGACG -> ACAATCTCAGAGGAGACGG
GACAATTACCAAAAAGCTG -> ACAATTACCAAAAAGCTGG
GACAATTTGCATCGAACAA -> ACAATTTGCATCGAACAAA
GACACCAAAAGGCGGTCGG -> ACACCAAAAGGCGGTCGGA
GACACGAGTATGATACATT -> ACACGAGTATGATACATTT
GACAGGTCCCAGAAGTGGC -> ACAGGTCCCAGAAGTGGCT
GACAGTCCTGTACGGTAAA -> ACAGTCCTGTACGGTAAAC
GACATCGATGGTGCCCGCT -> ACATCGATGGTGCCCGCTG
GACATGTTGATTTGCCGCC -> ACATGTTGATTTGCCGCCA
GACCACTTTAAAAAAGTTT -> ACCACTTTAAAAAAGTTTA
GACCAGAGTACTCATAACA -> ACCAGAGTACTCATAACAC
GACCATTGCGCGTGCCGCC -> ACCATTGCGCGTGCCGCCA
GACCCAAGATGGCGCTTGC -> ACCCAAGATGGCGCTTGCG
GACCCATTGGTCCGACAAC -> ACCCATTGGTCCGACAACC
GACCCTCGTCGGTACATGG -> ACCCTCGTCGGTACATGGG
GACCGATCGGCTAGCTGCA -> ACCGATCGGCTAGCTGCAC
GACCGCGTGAGCCCACTAA -> ACCGCGTGAGCCCACTAAG
GACCGGTGAGTCCACTGAA -> ACCGGTGAGTCCACTGAAT
GACCTGGTTGTTGCTGAAA -> ACCTGGTTGTTGCTGAAAG
GACGAAATGTCGTTCCGCC -> ACGAAATGTCGTTCCGCCA
GACGACATGTTGATTTGCC -> ACGACATGTTGATTTGCCG
GACGACCATTGCGCGTGCC -> ACGACCATTGCGCGTGCCG
GACGACGAAATGTCGTTCC -> ACGACGAAATGTCGTTCCG
GACGACTGATTCCTTACCC -> ACGACTGATTCCTTACCCG
GACGCGAGATACGCCCAGA -> ACGCGAGATACGCCCAGAT
GACGCTCTTAGGTTATGCC -> ACGCTCTTAGGTTATGCCG
GACGGGATAGAGTCTCGCA -> ACGGGATAGAGTCTCGCAC
GACGGTACAGGAGATCTTT -> ACGGTACAGGAGATCTTTC
GACGGTGGGTTCATACGTC -> ACGGTGGGTTCATACGTCG
GACGGTTACACTATTGGAA -> ACGGTTACACTATTGGAAG
GACGTATAACCCACCATCC -> ACGTATAACCCACCATCCC
GACGTCGACTTCAGACGAC -> ACGTCGACTTCAGACGACG
GACTACATGGCCATGGAAT -> ACTACATGGCCATGGAATA
GACTAGATTTGCACGTCGA -> ACTAGATTTGCACGTCGAC
GACTATAACAAGCTTTCAA -> ACTATAACAAGCTTTCAAG
GACTATAGGTATCCGTGAT -> ACTATAGGTATCCGTGATG
GACTATGACAGGTCCCAGA -> ACTATGACAGGTCCCAGAA
GACTCATCGACAATCTCAG -> ACTCATCGACAATCTCAGA
GACTCCCGGAAACTTCAGC -> ACTCCCGGAAACTTCAGCA
GACTCGCCGACAAAATAAT -> ACTCGCCGACAAAATAATA
GACTCGCCTAGGCAAACCT -> ACTCGCCTAGGCAAACCTG
GACTCGGGGGAGTTCCGTG -> ACTCGGGGGAGTTCCGTGG
GACTCTCCCGGGATATGCG -> ACTCTCCCGGGATATGCGG
GACTGATTCCTTACCCGCC -> ACTGATTCCTTACCCGCCA
GACTTCAGACGACATGTTG -> ACTTCAGACGACATGTTGA
GACTTCAGACGACCATTGC -> ACTTCAGACGACCATTGCG
GACTTCAGACGACGAAATG -> ACTTCAGACGACGAAATGT
GACTTCAGACGACTGATTC -> ACTTCAGACGACTGATTCC
GAGAAGGTAGGACGTCGAC -> AGAAGGTAGGACGTCGACT
GAGACGGTTACACTATTGG -> AGACGGTTACACTATTGGA
GAGACTATAACAAGCTTTC -> AGACTATAACAAGCTTTCA
GAGACTATAGGTATCCGTG -> AGACTATAGGTATCCGTGA
GAGAGGTTTGGCACGGTTG -> AGAGGTTTGGCACGGTTGC
GAGAGTAGAAGAAAGAGAC -> AGAGTAGAAGAAAGAGACT
GAGAGTTGGGGTGGCAGAG -> AGAGTTGGGGTGGCAGAGC
GAGATACGCCCAGATGACT -> AGATACGCCCAGATGACTA
GAGATCTTTCTTTGTCACG -> AGATCTTTCTTTGTCACGT
GAGATTTGGCCTCTGGAAC -> AGATTTGGCCTCTGGAACT
GAGCAAGATAACTGCTAGT -> AGCAAGATAACTGCTAGTA
GAGCACATGGCCACAAGTG -> AGCACATGGCCACAAGTGC
GAGCCCACTAAGTCCACTA -> AGCCCACTAAGTCCACTAG
GAGCCGGTTCTAGTCTAGA -> AGCCGGTTCTAGTCTAGAA
GAGCGGGAGTACTGCTACT -> AGCGGGAGTACTGCTACTG
GAGCGGTCAACAGGGAATG -> AGCGGTCAACAGGGAATGG
GAGGAAAAAACCATCTGAG -> AGGAAAAAACCATCTGAGG
GAGGAATATAAACTCCGGT -> AGGAATATAAACTCCGGTT
GAGGACTCGCCGACAAAAT -> AGGACTCGCCGACAAAATA
GAGGAGACGGTTACACTAT -> AGGAGACGGTTACACTATT
GAGGATGCGACGCGAGATA -> AGGATGCGACGCGAGATAC
GAGGCAAGGTCAGATGTCG -> AGGCAAGGTCAGATGTCGC
GAGGCTGTACTGTGGGAAA -> AGGCTGTACTGTGGGAAAT
GAGGGCAACCGAAACCGGC -> AGGGCAACCGAAACCGGCG
GAGGTTTGGCACGGTTGCA -> AGGTTTGGCACGGTTGCAC
GAGTACTCATAACACTGAT -> AGTACTCATAACACTGATG
GAGTACTGCTACTGATCGA -> AGTACTGCTACTGATCGAG
GAGTAGAAGAAAGAGACTA -> AGTAGAAGAAAGAGACTAT
GAGTAGGGGCCTCCACACG -> AGTAGGGGCCTCCACACGA
GAGTATGATACATTTTCTG -> AGTATGATACATTTTCTGT
GAGTCCACTGAATAGAACC -> AGTCCACTGAATAGAACCT
GAGTCTCGCACTACGAGTA -> AGTCTCGCACTACGAGTAG
GAGTGAATGCGATGACGGT -> AGTGAATGCGATGACGGTA
GAGTGGAGGAAAAAACCAT -> AGTGGAGGAAAAAACCATC
GAGTTACAGCCAATAAACA -> AGTTACAGCCAATAAACAT
GAGTTATGACGTATAACCC -> AGTTATGACGTATAACCCA
GAGTTCCGTGGCCACCGTT -> AGTTCCGTGGCCACCGTTC
GAGTTGAAAAAAGCCCATA -> AGTTGAAAAAAGCCCATAC
GAGTTGCACCCAATGGGGG -> AGTTGCACCCAATGGGGGA
GAGTTGGGGTGGCAGAGCA -> AGTTGGGGTGGCAGAGCAC
GATAACTGCTAGTAGCTAC -> ATAACTGCTAGTAGCTACA
GATACATTTTCTGTATGCA -> ATACATTTTCTGTATGCAA
GATACGCCCAGATGACTAT -> ATACGCCCAGATGACTATG
GATAGAGTCTCGCACTACG -> ATAGAGTCTCGCACTACGA
GATAGCTAATCCACCGAGT -> ATAGCTAATCCACCGAGTT
GATATGCGGCGCTGATCCT -> ATATGCGGCGCTGATCCTT
GATCACTAGTTTCACCCAG -> ATCACTAGTTTCACCCAGT
GATCCTTGCCATCACTCCG -> ATCCTTGCCATCACTCCGA
GATCGAGCCGGTTCTAGTC -> ATCGAGCCGGTTCTAGTCT
GATCGGCTAGCTGCACATA -> ATCGGCTAGCTGCACATAT
GATCTTATTTTGAAGGGCC -> ATCTTATTTTGAAGGGCCG
GATCTTTCTTTGTCACGTA -> ATCTTTCTTTGTCACGTAT
GATGACGGTACAGGAGATC -> ATGACGGTACAGGAGATCT
GATGACTATGACAGGTCCC -> ATGACTATGACAGGTCCCA
GATGAGCAAGATAACTGCT -> ATGAGCAAGATAACTGCTA
GATGATGGACTACATGGCC -> ATGATGGACTACATGGCCA
GATGCGACGCGAGATACGC -> ATGCGACGCGAGATACGCC
GATGCGACTCTCCCGGGAT -> ATGCGACTCTCCCGGGATA
GATGCTCATAACACGCTAC -> ATGCTCATAACACGCTACC
GATGCTCCGACCACTTTAA -> ATGCTCCGACCACTTTAAA
GATGGACTACATGGCCATG -> ATGGACTACATGGCCATGG
GATGGATGCGACTCTCCCG -> ATGGATGCGACTCTCCCGG
GATGGCATCCGGATTCGAT -> ATGGCATCCGGATTCGATC
GATGGCGCTTGCGGAAACT -> ATGGCGCTTGCGGAAACTC
GATGGTGCCCGCTGATGCT -> ATGGTGCCCGCTGATGCTC
GATGTCGCCGTGTGTAGCA -> ATGTCGCCGTGTGTAGCAC
GATGTTTCTTTAATAAACG -> ATGTTTCTTTAATAAACGC
GATTCCTTACCCGCCAGGG -> ATTCCTTACCCGCCAGGGT
GATTCGATCTTATTTTGAA -> ATTCGATCTTATTTTGAAG
GATTTGCACGTCGACTTCA -> ATTTGCACGTCGACTTCAG
GATTTGCCGCCAGGGTTCG -> ATTTGCCGCCAGGGTTCGT
GATTTGGCCTCTGGAACTA -> ATTTGGCCTCTGGAACTAG
GATTTTCGTGACAGTCCTG -> ATTTTCGTGACAGTCCTGT
GCAAACCTGGGACACGAGT -> CAAACCTGGGACACGAGTA
GCAAAGAACGAACCCGGCA -> CAAAGAACGAACCCGGCAG
GCAACCAATTTCCCGTACA -> CAACCAATTTCCCGTACAT
GCAACCCACGGCGGACGGG -> CAACCCACGGCGGACGGGA
GCAACCGAAACCGGCGTTG -> CAACCGAAACCGGCGTTGA
GCAACGTGTCGCACTGAGT -> CAACGTGTCGCACTGAGTG
GCAAGATAACTGCTAGTAG -> CAAGATAACTGCTAGTAGC
GCAAGGTCAGATGTCGCCG -> CAAGGTCAGATGTCGCCGT
GCAATAAATAATTTTTATG -> CAATAAATAATTTTTATGA
GCAATCTAGCCGTAGGTTG -> CAATCTAGCCGTAGGTTGA
GCACATATAATTCAGGTGT -> CACATATAATTCAGGTGTC
GCACATGGCCACAAGTGCG -> CACATGGCCACAAGTGCGA
GCACCAAATACTAGACTCG -> CACCAAATACTAGACTCGG
GCACCCAATGGGGGACCGA -> CACCCAATGGGGGACCGAT
GCACGCTCATTGGAGAGTA -> CACGCTCATTGGAGAGTAG
GCACGGTTGCACCAAATAC -> CACGGTTGCACCAAATACT
GCACGTCGACTTCAGACGA -> CACGTCGACTTCAGACGAC
GCACTACGAGTAGGGGCCT -> CACTACGAGTAGGGGCCTC
GCACTGAGTGAATGCGATG -> CACTGAGTGAATGCGATGA
GCACTGCTCAGAGGAATAT -> CACTGCTCAGAGGAATATA
GCACTTGAGTGGAGGAAAA -> CACTTGAGTGGAGGAAAAA
GCAGAGCACATGGCCACAA -> CAGAGCACATGGCCACAAG
GCAGCGATGCTCCGACCAC -> CAGCGATGCTCCGACCACT
GCAGCGCAACCAATTTCCC -> CAGCGCAACCAATTTCCCG
GCAGGAGGCAAGGTCAGAT -> CAGGAGGCAAGGTCAGATG
GCATCCGGATTCGATCTTA -> CATCCGGATTCGATCTTAT
GCATCGAACAAAGGAACTA -> CATCGAACAAAGGAACTAA
GCATTATCATTAGCAATAA -> CATTATCATTAGCAATAAA
GCATTCGCAACCCACGGCG -> CATTCGCAACCCACGGCGG
GCATTCGTCTCCAATACCT -> CATTCGTCTCCAATACCTA
GCATTTATGTATGGTTTAA -> CATTTATGTATGGTTTAAA
GCCAATAAACATGTGATGT -> CCAATAAACATGTGATGTT
GCCACAAGTGCGAGGGCAA -> CCACAAGTGCGAGGGCAAC
GCCACCGTTCCGGGTACAA -> CCACCGTTCCGGGTACAAA
GCCAGACCGGTGAGTCCAC -> CCAGACCGGTGAGTCCACT
GCCAGGGTTCGTCTGACCC -> CCAGGGTTCGTCTGACCCA
GCCAGGGTTCGTCTGACGC -> CCAGGGTTCGTCTGACGCT
GCCAGGGTTCGTCTGACGG -> CCAGGGTTCGTCTGACGGT
GCCAGGGTTCGTCTGACTC -> CCAGGGTTCGTCTGACTCG
GCCATCACTCCGAATTACA -> CCATCACTCCGAATTACAC
GCCATGGAATACTTAAACA -> CCATGGAATACTTAAACAA
GCCCACTAAGTCCACTAGC -> CCCACTAAGTCCACTAGCT
GCCCAGATGACTATGACAG -> CCCAGATGACTATGACAGG
GCCCATACGGGCACTGCTC -> CCCATACGGGCACTGCTCA
GCCCGCTGATGCTCATAAC -> CCCGCTGATGCTCATAACA
GCCCTTTAATCGGTCAGCC -> CCCTTTAATCGGTCAGCCT
GCCGACAAAATAATAACAT -> CCGACAAAATAATAACATA
GCCGCATTCGCAACCCACG -> CCGCATTCGCAACCCACGG
GCCGCCAGACCGGTGAGTC -> CCGCCAGACCGGTGAGTCC
GCCGCCAGGGTTCGTCTGA -> CCGCCAGGGTTCGTCTGAC,CCGCCAGGGTTCGTCTGAC
GCCGCTCATCCGATGAGCA -> CCGCTCATCCGATGAGCAA
GCCGGGAAGGGCCTATCCG -> CCGGGAAGGGCCTATCCGG
GCCGGTCACCATCTGGAGC -> CCGGTCACCATCTGGAGCG
GCCGGTTCTAGTCTAGAAT -> CCGGTTCTAGTCTAGAATC
GCCGTAGGTTGATGGCATC -> CCGTAGGTTGATGGCATCC
GCCGTGCGAAATGTATCTC -> CCGTGCGAAATGTATCTCA
GCCGTGTGTAGCACGCTCA -> CCGTGTGTAGCACGCTCAT
GCCTAACGACCGCGTGAGC -> CCTAACGACCGCGTGAGCC
GCCTAGGCAAACCTGGGAC -> CCTAGGCAAACCTGGGACA
GCCTATCCGGCTCAATCAC -> CCTATCCGGCTCAATCACT
GCCTCCACACGAAGTATGG -> CCTCCACACGAAGTATGGA
GCCTCTGGAACTAGACCCA -> CCTCTGGAACTAGACCCAT
GCCTTGGTCTTCATGGATT -> CCTTGGTCTTCATGGATTG
GCGAAATGTATCTCACGTA -> CGAAATGTATCTCACGTAA
GCGACAATTACCAAAAAGC -> CGACAATTACCAAAAAGCT
GCGACGCGAGATACGCCCA -> CGACGCGAGATACGCCCAG
GCGACTCTCCCGGGATATG -> CGACTCTCCCGGGATATGC
GCGAGATACGCCCAGATGA -> CGAGATACGCCCAGATGAC
GCGAGGGCAACCGAAACCG -> CGAGGGCAACCGAAACCGG
GCGAGTTGAAAAAAGCCCA -> CGAGTTGAAAAAAGCCCAT
GCGATGACGGTACAGGAGA -> CGATGACGGTACAGGAGAT
GCGATGCTCCGACCACTTT -> CGATGCTCCGACCACTTTA
GCGCAACCAATTTCCCGTA -> CGCAACCAATTTCCCGTAC
GCGCAGCGCAACCAATTTC -> CGCAGCGCAACCAATTTCC
GCGCGTGCCGCCAGGGTTC -> CGCGTGCCGCCAGGGTTCG
GCGCTGATCCTTGCCATCA -> CGCTGATCCTTGCCATCAC
GCGCTTGCGGAAACTCATC -> CGCTTGCGGAAACTCATCG
GCGGAAACTCATCGTAGGC -> CGGAAACTCATCGTAGGCA
GCGGACGGGATAGAGTCTC -> CGGACGGGATAGAGTCTCG
GCGGCGCTGATCCTTGCCA -> CGGCGCTGATCCTTGCCAT
GCGGGAGTACTGCTACTGA -> CGGGAGTACTGCTACTGAT
GCGGGCCGTGCGAAATGTA -> CGGGCCGTGCGAAATGTAT
GCGGTCAACAGGGAATGGT -> CGGTCAACAGGGAATGGTT
GCGGTCGGACCCTCGTCGG -> CGGTCGGACCCTCGTCGGT
GCGTATAGGGGGGAGTTGC -> CGTATAGGGGGGAGTTGCA
GCGTATGTCACACTATCGC -> CGTATGTCACACTATCGCA
GCGTGAGCCCACTAAGTCC -> CGTGAGCCCACTAAGTCCA
GCGTGCCGCCAGGGTTCGT -> CGTGCCGCCAGGGTTCGTC
GCGTTGAACAACGAATCTT -> CGTTGAACAACGAATCTTC
GCTAATCCACCGAGTTACA -> CTAATCCACCGAGTTACAG
GCTACAGGTGGACATCGAT -> CTACAGGTGGACATCGATG
GCTACCAGACCTGGTTGTT -> CTACCAGACCTGGTTGTTG
GCTACTGATCGAGCCGGTT -> CTACTGATCGAGCCGGTTC
GCTACTTCTCCGACTCATC -> CTACTTCTCCGACTCATCG
GCTAGCTGCACATATAATT -> CTAGCTGCACATATAATTC
GCTAGTAGCTACAGGTGGA -> CTAGTAGCTACAGGTGGAC
GCTATATCTGCGCAGCGCA -> CTATATCTGCGCAGCGCAA
GCTCAATCACTAATACCAA -> CTCAATCACTAATACCAAT
GCTCAGAGGAATATAAACT -> CTCAGAGGAATATAAACTC
GCTCAGAGGACTCGCCGAC -> CTCAGAGGACTCGCCGACA
GCTCATAACACGCTACCAG -> CTCATAACACGCTACCAGA
GCTCATCCGATGAGCAAGA -> CTCATCCGATGAGCAAGAT
GCTCATTGGAGAGTAGAAG -> CTCATTGGAGAGTAGAAGA
GCTCCGACCACTTTAAAAA -> CTCCGACCACTTTAAAAAA
GCTCTTAGGTTATGCCGCC -> CTCTTAGGTTATGCCGCCA
GCTGAAAGGCGGGCCGTGC -> CTGAAAGGCGGGCCGTGCG
GCTGATCCTTGCCATCACT -> CTGATCCTTGCCATCACTC
GCTGATGCTCATAACACGC -> CTGATGCTCATAACACGCT
GCTGCAACGTGTCGCACTG -> CTGCAACGTGTCGCACTGA
GCTGCACATATAATTCAGG -> CTGCACATATAATTCAGGT
GCTGGGCCTAACGACCGCG -> CTGGGCCTAACGACCGCGT
GCTGTACTGTGGGAAATTG -> CTGTACTGTGGGAAATTGT
GCTTGCGGAAACTCATCGT -> CTTGCGGAAACTCATCGTA
GCTTTCAAGCATTCGTCTC -> CTTTCAAGCATTCGTCTCC
GCTTTTGTTAATGGGACTC -> CTTTTGTTAATGGGACTCC
GGAAAAAACCATCTGAGGA -> GAAAAAACCATCTGAGGAT
GGAAACTCATCGTAGGCAC -> GAAACTCATCGTAGGCACT
GGAAACTTCAGCAGGAGGC -> GAAACTTCAGCAGGAGGCA
GGAAATTGTGGTTAGACTA -> GAAATTGTGGTTAGACTAG
GGAACCAGTCCACATAGTC -> GAACCAGTCCACATAGTCA
GGAACGGCAATCTAGCCGT -> GAACGGCAATCTAGCCGTA
GGAACTAATAGAGAAGGTA -> GAACTAATAGAGAAGGTAG
GGAACTAGACCCATTGGTC -> GAACTAGACCCATTGGTCC
GGAAGGGCCTATCCGGCTC -> GAAGGGCCTATCCGGCTCA
GGAAGTGTTTGACACCAAA -> GAAGTGTTTGACACCAAAA
GGAATACTTAAACAAATTT -> GAATACTTAAACAAATTTG
GGAATATAAACTCCGGTTT -> GAATATAAACTCCGGTTTT
GGAATCGGATCACTAGTTT -> GAATCGGATCACTAGTTTC
GGAATGGTTAGGGTGTTTG -> GAATGGTTAGGGTGTTTGA
GGACACGAGTATGATACAT -> GACACGAGTATGATACATT
GGACATCGATGGTGCCCGC -> GACATCGATGGTGCCCGCT
GGACCCTCGTCGGTACATG -> GACCCTCGTCGGTACATGG
GGACCGATCGGCTAGCTGC -> GACCGATCGGCTAGCTGCA
GGACGGGATAGAGTCTCGC -> GACGGGATAGAGTCTCGCA
GGACGTCGACTTCAGACGA -> GACGTCGACTTCAGACGAC
GGACTACATGGCCATGGAA -> GACTACATGGCCATGGAAT
GGACTCCCGGAAACTTCAG -> GACTCCCGGAAACTTCAGC
GGACTCGCCGACAAAATAA -> GACTCGCCGACAAAATAAT
GGAGACGGTTACACTATTG -> GAGACGGTTACACTATTGG
GGAGAGTAGAAGAAAGAGA -> GAGAGTAGAAGAAAGAGAC
GGAGATCTTTCTTTGTCAC -> GAGATCTTTCTTTGTCACG
GGAGCGGGAGTACTGCTAC -> GAGCGGGAGTACTGCTACT
GGAGCGGTCAACAGGGAAT -> GAGCGGTCAACAGGGAATG
GGAGGAAAAAACCATCTGA -> GAGGAAAAAACCATCTGAG
GGAGGCAAGGTCAGATGTC -> GAGGCAAGGTCAGATGTCG
GGAGTACTGCTACTGATCG -> GAGTACTGCTACTGATCGA
GGAGTTCCGTGGCCACCGT -> GAGTTCCGTGGCCACCGTT
GGAGTTGCACCCAATGGGG -> GAGTTGCACCCAATGGGGG
GGATAGAGTCTCGCACTAC -> GATAGAGTCTCGCACTACG
GGATAGCTAATCCACCGAG -> GATAGCTAATCCACCGAGT
GGATATGCGGCGCTGATCC -> GATATGCGGCGCTGATCCT
GGATCACTAGTTTCACCCA -> GATCACTAGTTTCACCCAG
GGATGCGACGCGAGATACG -> GATGCGACGCGAGATACGC
GGATGCGACTCTCCCGGGA -> GATGCGACTCTCCCGGGAT
GGATTCGATCTTATTTTGA -> GATTCGATCTTATTTTGAA
GGCAAACCTGGGACACGAG -> GCAAACCTGGGACACGAGT
GGCAACCGAAACCGGCGTT -> GCAACCGAAACCGGCGTTG
GGCAAGGTCAGATGTCGCC -> GCAAGGTCAGATGTCGCCG
GGCAATCTAGCCGTAGGTT -> GCAATCTAGCCGTAGGTTG
GGCACGGTTGCACCAAATA -> GCACGGTTGCACCAAATAC
GGCACTGCTCAGAGGAATA -> GCACTGCTCAGAGGAATAT
GGCACTTGAGTGGAGGAAA -> GCACTTGAGTGGAGGAAAA
GGCAGAGCACATGGCCACA -> GCAGAGCACATGGCCACAA
GGCAGCGATGCTCCGACCA -> GCAGCGATGCTCCGACCAC
GGCATCCGGATTCGATCTT -> GCATCCGGATTCGATCTTA
GGCCACAAGTGCGAGGGCA -> GCCACAAGTGCGAGGGCAA
GGCCACCGTTCCGGGTACA -> GCCACCGTTCCGGGTACAA
GGCCATGGAATACTTAAAC -> GCCATGGAATACTTAAACA
GGCCGCATTCGCAACCCAC -> GCCGCATTCGCAACCCACG
GGCCGCTCATCCGATGAGC -> GCCGCTCATCCGATGAGCA
GGCCGGTCACCATCTGGAG -> GCCGGTCACCATCTGGAGC
GGCCGTGCGAAATGTATCT -> GCCGTGCGAAATGTATCTC
GGCCTAACGACCGCGTGAG -> GCCTAACGACCGCGTGAGC
GGCCTATCCGGCTCAATCA -> GCCTATCCGGCTCAATCAC
GGCCTCCACACGAAGTATG -> GCCTCCACACGAAGTATGG
GGCCTCTGGAACTAGACCC -> GCCTCTGGAACTAGACCCA
GGCGACAATTACCAAAAAG -> GCGACAATTACCAAAAAGC
GGCGAGTTGAAAAAAGCCC -> GCGAGTTGAAAAAAGCCCA
GGCGCTGATCCTTGCCATC -> GCGCTGATCCTTGCCATCA
GGCGCTTGCGGAAACTCAT -> GCGCTTGCGGAAACTCATC
GGCGGACGGGATAGAGTCT -> GCGGACGGGATAGAGTCTC
GGCGGGCCGTGCGAAATGT -> GCGGGCCGTGCGAAATGTA
GGCGGTCGGACCCTCGTCG -> GCGGTCGGACCCTCGTCGG
GGCGTATAGGGGGGAGTTG -> GCGTATAGGGGGGAGTTGC
GGCGTTGAACAACGAATCT -> GCGTTGAACAACGAATCTT
GGCTACTTCTCCGACTCAT -> GCTACTTCTCCGACTCATC
GGCTAGCTGCACATATAAT -> GCTAGCTGCACATATAATT
GGCTCAATCACTAATACCA -> GCTCAATCACTAATACCAA
GGCTGCAACGTGTCGCACT -> GCTGCAACGTGTCGCACTG
GGCTGTACTGTGGGAAATT -> GCTGTACTGTGGGAAATTG
GGGAAATTGTGGTTAGACT -> GGAAATTGTGGTTAGACTA
GGGAACGGCAATCTAGCCG -> GGAACGGCAATCTAGCCGT
GGGAAGGGCCTATCCGGCT -> GGAAGGGCCTATCCGGCTC
GGGAATGGTTAGGGTGTTT -> GGAATGGTTAGGGTGTTTG
GGGACACGAGTATGATACA -> GGACACGAGTATGATACAT
GGGACCGATCGGCTAGCTG -> GGACCGATCGGCTAGCTGC
GGGACTCCCGGAAACTTCA -> GGACTCCCGGAAACTTCAG
GGGAGTACTGCTACTGATC -> GGAGTACTGCTACTGATCG
GGGAGTTCCGTGGCCACCG -> GGAGTTCCGTGGCCACCGT
GGGAGTTGCACCCAATGGG -> GGAGTTGCACCCAATGGGG
GGGATAGAGTCTCGCACTA -> GGATAGAGTCTCGCACTAC
GGGATATGCGGCGCTGATC -> GGATATGCGGCGCTGATCC
GGGCAACCGAAACCGGCGT -> GGCAACCGAAACCGGCGTT
GGGCACTGCTCAGAGGAAT -> GGCACTGCTCAGAGGAATA
GGGCCGCTCATCCGATGAG -> GGCCGCTCATCCGATGAGC
GGGCCGTGCGAAATGTATC -> GGCCGTGCGAAATGTATCT
GGGCCTAACGACCGCGTGA -> GGCCTAACGACCGCGTGAG
GGGCCTATCCGGCTCAATC -> GGCCTATCCGGCTCAATCA
GGGCCTCCACACGAAGTAT -> GGCCTCCACACGAAGTATG
GGGCGTATAGGGGGGAGTT -> GGCGTATAGGGGGGAGTTG
GGGGAACGGCAATCTAGCC -> GGGAACGGCAATCTAGCCG
GGGGACCGATCGGCTAGCT -> GGGACCGATCGGCTAGCTG
GGGGAGTTCCGTGGCCACC -> GGGAGTTCCGTGGCCACCG
GGGGAGTTGCACCCAATGG -> GGGAGTTGCACCCAATGGG
GGGGCCTCCACACGAAGTA -> GGGCCTCCACACGAAGTAT
GGGGGACCGATCGGCTAGC -> GGGGACCGATCGGCTAGCT
GGGGGAGTTCCGTGGCCAC -> GGGGAGTTCCGTGGCCACC
GGGGGAGTTGCACCCAATG -> GGGGAGTTGCACCCAATGG
GGGGGGAGTTGCACCCAAT -> GGGGGAGTTGCACCCAATG
GGGGTGGCAGAGCACATGG -> GGGTGGCAGAGCACATGGC
GGGTACAAATCCAAATAGT -> GGTACAAATCCAAATAGTT
GGGTCTGAGAGTTGGGGTG -> GGTCTGAGAGTTGGGGTGG
GGGTGGCAGAGCACATGGC -> GGTGGCAGAGCACATGGCC
GGGTGTTTGAAATGGCTGC -> GGTGTTTGAAATGGCTGCA
GGGTTCATACGTCGACTTC -> GGTTCATACGTCGACTTCA
GGGTTCGTCTGACCCAAGA -> GGTTCGTCTGACCCAAGAT
GGGTTCGTCTGACGCTCTT -> GGTTCGTCTGACGCTCTTA
GGGTTCGTCTGACGGTGGG -> GGTTCGTCTGACGGTGGGT
GGGTTCGTCTGACTCGCCT -> GGTTCGTCTGACTCGCCTA
GGTAAACATCAGGAACCAG -> GTAAACATCAGGAACCAGT
GGTACAAATCCAAATAGTT -> GTACAAATCCAAATAGTTC
GGTACAGGAGATCTTTCTT -> GTACAGGAGATCTTTCTTT
GGTACATGGGGAACGGCAA -> GTACATGGGGAACGGCAAT
GGTAGGACGTCGACTTCAG -> GTAGGACGTCGACTTCAGA
GGTATCCGTGATGATGGAC -> GTATCCGTGATGATGGACT
GGTCAACAGGGAATGGTTA -> GTCAACAGGGAATGGTTAG
GGTCACCATCTGGAGCGGG -> GTCACCATCTGGAGCGGGA
GGTCAGATGTCGCCGTGTG -> GTCAGATGTCGCCGTGTGT
GGTCAGCCTTGGTCTTCAT -> GTCAGCCTTGGTCTTCATG
GGTCCCAGAAGTGGCTACT -> GTCCCAGAAGTGGCTACTT
GGTCCGACAACCGACAATT -> GTCCGACAACCGACAATTT
GGTCGGACCCTCGTCGGTA -> GTCGGACCCTCGTCGGTAC
GGTCTGAGAGTTGGGGTGG -> GTCTGAGAGTTGGGGTGGC
GGTCTTCATGGATTGTCTG -> GTCTTCATGGATTGTCTGG
GGTGAGTCCACTGAATAGA -> GTGAGTCCACTGAATAGAA
GGTGCCCGCTGATGCTCAT -> GTGCCCGCTGATGCTCATA
GGTGGACATCGATGGTGCC -> GTGGACATCGATGGTGCCC
GGTGGCAGAGCACATGGCC -> GTGGCAGAGCACATGGCCA
GGTGGGTTCATACGTCGAC -> GTGGGTTCATACGTCGACT
GGTGTCCTTATGGAATCGG -> GTGTCCTTATGGAATCGGA
GGTGTTTGAAATGGCTGCA -> GTGTTTGAAATGGCTGCAA
GGTTACACTATTGGAAGTG -> GTTACACTATTGGAAGTGT
GGTTAGACTAGATTTGCAC -> GTTAGACTAGATTTGCACG
GGTTAGGGTGTTTGAAATG -> GTTAGGGTGTTTGAAATGG
GGTTATGCCGCCAGACCGG -> GTTATGCCGCCAGACCGGT
GGTTCATACGTCGACTTCA -> GTTCATACGTCGACTTCAG
GGTTCGTCTGACCCAAGAT -> GTTCGTCTGACCCAAGATG
GGTTCGTCTGACGCTCTTA -> GTTCGTCTGACGCTCTTAG
GGTTCGTCTGACGGTGGGT -> GTTCGTCTGACGGTGGGTT
GGTTCGTCTGACTCGCCTA -> GTTCGTCTGACTCGCCTAG
GGTTCTAGTCTAGAATCTC -> GTTCTAGTCTAGAATCTCC
GGTTGATGGCATCCGGATT -> GTTGATGGCATCCGGATTC
GGTTGCACCAAATACTAGA -> GTTGCACCAAATACTAGAC
GGTTGTTGCTGAAAGGCGG -> GTTGTTGCTGAAAGGCGGG
GGTTTAAAAACGTTTGAGG -> GTTTAAAAACGTTTGAGGC
GGTTTGGCACGGTTGCACC -> GTTTGGCACGGTTGCACCA
GGTTTTTTGCCCTTTAATC -> GTTTTTTGCCCTTTAATCG
GTAAACATCAGGAACCAGT -> TAAACATCAGGAACCAGTC
GTAAATGAGACTATAACAA -> TAAATGAGACTATAACAAG
GTAATCAACGTCGACTTCA -> TAATCAACGTCGACTTCAG
GTACAAATCCAAATAGTTC -> TACAAATCCAAATAGTTCA
GTACAGGAGATCTTTCTTT -> TACAGGAGATCTTTCTTTG
GTACATATTCACTGCATTT -> TACATATTCACTGCATTTA
GTACATGGGGAACGGCAAT -> TACATGGGGAACGGCAATC
GTACGGTAAACATCAGGAA -> TACGGTAAACATCAGGAAC
GTACTCATAACACTGATGG -> TACTCATAACACTGATGGA
GTACTGCTACTGATCGAGC -> TACTGCTACTGATCGAGCC
GTACTGTGGGAAATTGTGG -> TACTGTGGGAAATTGTGGT
GTAGAAGAAAGAGACTATA -> TAGAAGAAAGAGACTATAG
GTAGCACGCTCATTGGAGA -> TAGCACGCTCATTGGAGAG
GTAGCTACAGGTGGACATC -> TAGCTACAGGTGGACATCG
GTAGGACGTCGACTTCAGA -> TAGGACGTCGACTTCAGAC
GTAGGCACTTGAGTGGAGG -> TAGGCACTTGAGTGGAGGA
GTAGGGGCCTCCACACGAA -> TAGGGGCCTCCACACGAAG
GTAGGTTGATGGCATCCGG -> TAGGTTGATGGCATCCGGA
GTATAACCCACCATCCCAA -> TATAACCCACCATCCCAAT
GTATAGGGGGGAGTTGCAC -> TATAGGGGGGAGTTGCACC
GTATCCGTGATGATGGACT -> TATCCGTGATGATGGACTA
GTATCTCACGTAAATGAGA -> TATCTCACGTAAATGAGAC
GTATGATACATTTTCTGTA -> TATGATACATTTTCTGTAT
GTATGCAAAGAACGAACCC -> TATGCAAAGAACGAACCCG
GTATGGAGCGGTCAACAGG -> TATGGAGCGGTCAACAGGG
GTATGGCCGGTCACCATCT -> TATGGCCGGTCACCATCTG
GTATGGTTTAAAAACGTTT -> TATGGTTTAAAAACGTTTG
GTATGTCACACTATCGCAT -> TATGTCACACTATCGCATT
GTCAACAGGGAATGGTTAG -> TCAACAGGGAATGGTTAGG
GTCAATTGTTTACCATGGG -> TCAATTGTTTACCATGGGC
GTCACACTATCGCATTATC -> TCACACTATCGCATTATCA
GTCACCATCTGGAGCGGGA -> TCACCATCTGGAGCGGGAG
GTCACGTATGGCCGGTCAC -> TCACGTATGGCCGGTCACC
GTCAGATGTCGCCGTGTGT -> TCAGATGTCGCCGTGTGTA
GTCAGCCTTGGTCTTCATG -> TCAGCCTTGGTCTTCATGG
GTCCACATAGTCAATTGTT -> TCCACATAGTCAATTGTTT
GTCCACTAGCTATATCTGC -> TCCACTAGCTATATCTGCG
GTCCACTGAATAGAACCTA -> TCCACTGAATAGAACCTAA
GTCCCAGAAGTGGCTACTT -> TCCCAGAAGTGGCTACTTC
GTCCGACAACCGACAATTT -> TCCGACAACCGACAATTTG
GTCCTGTACGGTAAACATC -> TCCTGTACGGTAAACATCA
GTCCTTATGGAATCGGATC -> TCCTTATGGAATCGGATCA
GTCGACTTCAGACGACATG -> TCGACTTCAGACGACATGT
GTCGACTTCAGACGACCAT -> TCGACTTCAGACGACCATT
GTCGACTTCAGACGACGAA -> TCGACTTCAGACGACGAAA
GTCGACTTCAGACGACTGA -> TCGACTTCAGACGACTGAT
GTCGCACTGAGTGAATGCG -> TCGCACTGAGTGAATGCGA
GTCGCCGTGTGTAGCACGC -> TCGCCGTGTGTAGCACGCT
GTCGGACCCTCGTCGGTAC -> TCGGACCCTCGTCGGTACA
GTCGGTACATGGGGAACGG -> TCGGTACATGGGGAACGGC
GTCGTTCCGCCAGGGTTCG -> TCGTTCCGCCAGGGTTCGT
GTCTAGAATCTCCTTCTTG -> TCTAGAATCTCCTTCTTGC
GTCTCCAATACCTACTCTT -> TCTCCAATACCTACTCTTC
GTCTCGCACTACGAGTAGG -> TCTCGCACTACGAGTAGGG
GTCTGACCAGAGTACTCAT -> TCTGACCAGAGTACTCATA
GTCTGACCCAAGATGGCGC -> TCTGACCCAAGATGGCGCT
GTCTGACGCTCTTAGGTTA -> TCTGACGCTCTTAGGTTAT
GTCTGACGGTGGGTTCATA -> TCTGACGGTGGGTTCATAC
GTCTGACTCGCCTAGGCAA -> TCTGACTCGCCTAGGCAAA
GTCTGAGAGTTGGGGTGGC -> TCTGAGAGTTGGGGTGGCA
GTCTTCATGGATTGTCTGG -> TCTTCATGGATTGTCTGGT
GTGAATGCGATGACGGTAC -> TGAATGCGATGACGGTACA
GTGACAGTCCTGTACGGTA -> TGACAGTCCTGTACGGTAA
GTGAGATTTGGCCTCTGGA -> TGAGATTTGGCCTCTGGAA
GTGAGCCCACTAAGTCCAC -> TGAGCCCACTAAGTCCACT
GTGAGTCCACTGAATAGAA -> TGAGTCCACTGAATAGAAC
GTGAGTTATGACGTATAAC -> TGAGTTATGACGTATAACC
GTGATGATGGACTACATGG -> TGATGATGGACTACATGGC
GTGATGTTTCTTTAATAAA -> TGATGTTTCTTTAATAAAC
GTGCCCGCTGATGCTCATA -> TGCCCGCTGATGCTCATAA
GTGCCGCCAGGGTTCGTCT -> TGCCGCCAGGGTTCGTCTG
GTGCGAAATGTATCTCACG -> TGCGAAATGTATCTCACGT
GTGCGAGGGCAACCGAAAC -> TGCGAGGGCAACCGAAACC
GTGGACATCGATGGTGCCC -> TGGACATCGATGGTGCCCG
GTGGAGGAAAAAACCATCT -> TGGAGGAAAAAACCATCTG
GTGGCAGAGCACATGGCCA -> TGGCAGAGCACATGGCCAC
GTGGCCACCGTTCCGGGTA -> TGGCCACCGTTCCGGGTAC
GTGGCTACTTCTCCGACTC -> TGGCTACTTCTCCGACTCA
GTGGGAAATTGTGGTTAGA -> TGGGAAATTGTGGTTAGAC
GTGGGTTCATACGTCGACT -> TGGGTTCATACGTCGACTT
GTGGTTAGACTAGATTTGC -> TGGTTAGACTAGATTTGCA
GTGTAGCACGCTCATTGGA -> TGTAGCACGCTCATTGGAG
GTGTCCTTATGGAATCGGA -> TGTCCTTATGGAATCGGAT
GTGTCGCACTGAGTGAATG -> TGTCGCACTGAGTGAATGC
GTGTGTAGCACGCTCATTG -> TGTGTAGCACGCTCATTGG
GTGTTTGAAATGGCTGCAA -> TGTTTGAAATGGCTGCAAC
GTGTTTGACACCAAAAGGC -> TGTTTGACACCAAAAGGCG
GTTAATGGGACTCCCGGAA -> TTAATGGGACTCCCGGAAA
GTTACACTATTGGAAGTGT -> TTACACTATTGGAAGTGTT
GTTACAGCCAATAAACATG -> TTACAGCCAATAAACATGT
GTTAGACTAGATTTGCACG -> TTAGACTAGATTTGCACGT
GTTAGGGTGTTTGAAATGG -> TTAGGGTGTTTGAAATGGC
GTTATGACGTATAACCCAC -> TTATGACGTATAACCCACC
GTTATGCCGCCAGACCGGT -> TTATGCCGCCAGACCGGTG
GTTCAAATGGGTCTGAGAG -> TTCAAATGGGTCTGAGAGT
GTTCATACGTCGACTTCAG -> TTCATACGTCGACTTCAGA
GTTCCGCCAGGGTTCGTCT -> TTCCGCCAGGGTTCGTCTG
GTTCCGGGTACAAATCCAA -> TTCCGGGTACAAATCCAAA
GTTCCGTGGCCACCGTTCC -> TTCCGTGGCCACCGTTCCG
GTTCGTCTGACCCAAGATG -> TTCGTCTGACCCAAGATGG
GTTCGTCTGACGCTCTTAG -> TTCGTCTGACGCTCTTAGG
GTTCGTCTGACGGTGGGTT -> TTCGTCTGACGGTGGGTTC
GTTCGTCTGACTCGCCTAG -> TTCGTCTGACTCGCCTAGG
GTTCTAGTCTAGAATCTCC -> TTCTAGTCTAGAATCTCCT
GTTGAAAAAAGCCCATACG -> TTGAAAAAAGCCCATACGG
GTTGAACAACGAATCTTCT -> TTGAACAACGAATCTTCTC
GTTGATGGCATCCGGATTC -> TTGATGGCATCCGGATTCG
GTTGATTTGCCGCCAGGGT -> TTGATTTGCCGCCAGGGTT
GTTGCACCAAATACTAGAC -> TTGCACCAAATACTAGACT
GTTGCACCCAATGGGGGAC -> TTGCACCCAATGGGGGACC
GTTGCTGAAAGGCGGGCCG -> TTGCTGAAAGGCGGGCCGT
GTTGGGGTGGCAGAGCACA -> TTGGGGTGGCAGAGCACAT
GTTGTTGCTGAAAGGCGGG -> TTGTTGCTGAAAGGCGGGC
GTTTAAAAACGTTTGAGGC -> TTTAAAAACGTTTGAGGCT
GTTTACCATGGGCGTATAG -> TTTACCATGGGCGTATAGG
GTTTATCTGTGAGTTATGA -> TTTATCTGTGAGTTATGAC
GTTTCACCCAGTGAGATTT -> TTTCACCCAGTGAGATTTG
GTTTCTTTAATAAACGCGT -> TTTCTTTAATAAACGCGTA
GTTTGAAATGGCTGCAACG -> TTTGAAATGGCTGCAACGT
GTTTGACACCAAAAGGCGG -> TTTGACACCAAAAGGCGGT
GTTTGAGGCTGTACTGTGG -> TTTGAGGCTGTACTGTGGG
GTTTGGCACGGTTGCACCA -> TTTGGCACGGTTGCACCAA
GTTTTTTGCCCTTTAATCG -> TTTTTTGCCCTTTAATCGG
TAAAAAAGTTTATCTGTGA -> AAAAAAGTTTATCTGTGAG
TAAAAACGTTTGAGGCTGT -> AAAAACGTTTGAGGCTGTA
TAAACAAATTTGGCGAGTT -> AAACAAATTTGGCGAGTTG
TAAACATCAGGAACCAGTC -> AAACATCAGGAACCAGTCC
TAAACATGTGATGTTTCTT -> AAACATGTGATGTTTCTTT
TAAACGCGTATGTCACACT -> AAACGCGTATGTCACACTA
TAAACTCCGGTTTTTTGCC -> AAACTCCGGTTTTTTGCCC
TAAATAATTTTTATGAGAG -> AAATAATTTTTATGAGAGG
TAAATGAGACTATAACAAG -> AAATGAGACTATAACAAGC
TAAATGTCTGACCAGAGTA -> AAATGTCTGACCAGAGTAC
TAACAAGCTTTCAAGCATT -> AACAAGCTTTCAAGCATTC
TAACACGCTACCAGACCTG -> AACACGCTACCAGACCTGG
TAACACTGATGGATGCGAC -> AACACTGATGGATGCGACT
TAACATATATGAAATCGCT -> AACATATATGAAATCGCTT
TAACCCACCATCCCAATGT -> AACCCACCATCCCAATGTA
TAACGACCGCGTGAGCCCA -> AACGACCGCGTGAGCCCAC
TAACTGCTAGTAGCTACAG -> AACTGCTAGTAGCTACAGG
TAAGTCCACTAGCTATATC -> AAGTCCACTAGCTATATCT
TAATAAACGCGTATGTCAC -> AATAAACGCGTATGTCACA
TAATAACATATATGAAATC -> AATAACATATATGAAATCG
TAATACCAATCACTTGGCG -> AATACCAATCACTTGGCGA
TAATAGAGAAGGTAGGACG -> AATAGAGAAGGTAGGACGT
TAATCAACGTCGACTTCAG -> AATCAACGTCGACTTCAGA
TAATCCACCGAGTTACAGC -> AATCCACCGAGTTACAGCC
TAATCGGTCAGCCTTGGTC -> AATCGGTCAGCCTTGGTCT
TAATGGGACTCCCGGAAAC -> AATGGGACTCCCGGAAACT
TAATTCAGGTGTCCTTATG -> AATTCAGGTGTCCTTATGG
TAATTTTTATGAGAGGTTT -> AATTTTTATGAGAGGTTTG
TACAAATCCAAATAGTTCA -> ACAAATCCAAATAGTTCAA
TACACACAACATGGCCGCA -> ACACACAACATGGCCGCAT
TACACTATTGGAAGTGTTT -> ACACTATTGGAAGTGTTTG
TACAGCCAATAAACATGTG -> ACAGCCAATAAACATGTGA
TACAGGAGATCTTTCTTTG -> ACAGGAGATCTTTCTTTGT
TACAGGTGGACATCGATGG -> ACAGGTGGACATCGATGGT
TACATATTCACTGCATTTA -> ACATATTCACTGCATTTAT
TACATGGCCATGGAATACT -> ACATGGCCATGGAATACTT
TACATGGGGAACGGCAATC -> ACATGGGGAACGGCAATCT
TACATTTTCTGTATGCAAA -> ACATTTTCTGTATGCAAAG
TACCAAAAAGCTGGGCCTA -> ACCAAAAAGCTGGGCCTAA
TACCAATCACTTGGCGACA -> ACCAATCACTTGGCGACAA
TACCAGACCTGGTTGTTGC -> ACCAGACCTGGTTGTTGCT
TACCATGGGCGTATAGGGG -> ACCATGGGCGTATAGGGGG
TACCCGCCAGGGTTCGTCT -> ACCCGCCAGGGTTCGTCTG
TACCTACTCTTCGCCGGGA -> ACCTACTCTTCGCCGGGAA
TACGAGTAGGGGCCTCCAC -> ACGAGTAGGGGCCTCCACA
TACGCCCAGATGACTATGA -> ACGCCCAGATGACTATGAC
TACGGGCACTGCTCAGAGG -> ACGGGCACTGCTCAGAGGA
TACGGTAAACATCAGGAAC -> ACGGTAAACATCAGGAACC
TACGTCGACTTCAGACGAC -> ACGTCGACTTCAGACGACT
TACTAGACTCGGGGGAGTT -> ACTAGACTCGGGGGAGTTC
TACTCATAACACTGATGGA -> ACTCATAACACTGATGGAT
TACTCTTCGCCGGGAAGGG -> ACTCTTCGCCGGGAAGGGC
TACTGATCGAGCCGGTTCT -> ACTGATCGAGCCGGTTCTA
TACTGCTACTGATCGAGCC -> ACTGCTACTGATCGAGCCG
TACTGTGGGAAATTGTGGT -> ACTGTGGGAAATTGTGGTT
TACTTAAACAAATTTGGCG -> ACTTAAACAAATTTGGCGA
TACTTCTCCGACTCATCGA -> ACTTCTCCGACTCATCGAC
TAGAACCTAAATGTCTGAC -> AGAACCTAAATGTCTGACC
TAGAAGAAAGAGACTATAG -> AGAAGAAAGAGACTATAGG
TAGAATCTCCTTCTTGCTC -> AGAATCTCCTTCTTGCTCA
TAGACCCATTGGTCCGACA -> AGACCCATTGGTCCGACAA
TAGACTAGATTTGCACGTC -> AGACTAGATTTGCACGTCG
TAGACTCGGGGGAGTTCCG -> AGACTCGGGGGAGTTCCGT
TAGAGAAGGTAGGACGTCG -> AGAGAAGGTAGGACGTCGA
TAGAGTCTCGCACTACGAG -> AGAGTCTCGCACTACGAGT
TAGATTTGCACGTCGACTT -> AGATTTGCACGTCGACTTC
TAGCAATAAATAATTTTTA -> AGCAATAAATAATTTTTAT
TAGCACGCTCATTGGAGAG -> AGCACGCTCATTGGAGAGT
TAGCCGTAGGTTGATGGCA -> AGCCGTAGGTTGATGGCAT
TAGCTAATCCACCGAGTTA -> AGCTAATCCACCGAGTTAC
TAGCTACAGGTGGACATCG -> AGCTACAGGTGGACATCGA
TAGCTATATCTGCGCAGCG -> AGCTATATCTGCGCAGCGC
TAGCTGCACATATAATTCA -> AGCTGCACATATAATTCAG
TAGGACGTCGACTTCAGAC -> AGGACGTCGACTTCAGACG
TAGGCAAACCTGGGACACG -> AGGCAAACCTGGGACACGA
TAGGCACTTGAGTGGAGGA -> AGGCACTTGAGTGGAGGAA
TAGGGGCCTCCACACGAAG -> AGGGGCCTCCACACGAAGT
TAGGGGGGAGTTGCACCCA -> AGGGGGGAGTTGCACCCAA
TAGGGTGTTTGAAATGGCT -> AGGGTGTTTGAAATGGCTG
TAGGTATCCGTGATGATGG -> AGGTATCCGTGATGATGGA
TAGGTTATGCCGCCAGACC -> AGGTTATGCCGCCAGACCG
TAGGTTGATGGCATCCGGA -> AGGTTGATGGCATCCGGAT
TAGTAGCTACAGGTGGACA -> AGTAGCTACAGGTGGACAT
TAGTCAATTGTTTACCATG -> AGTCAATTGTTTACCATGG
TAGTCTAGAATCTCCTTCT -> AGTCTAGAATCTCCTTCTT
TAGTTCAAATGGGTCTGAG -> AGTTCAAATGGGTCTGAGA
TAGTTTCACCCAGTGAGAT -> AGTTTCACCCAGTGAGATT
TATAAACTCCGGTTTTTTG -> ATAAACTCCGGTTTTTTGC
TATAACAAGCTTTCAAGCA -> ATAACAAGCTTTCAAGCAT
TATAACCCACCATCCCAAT -> ATAACCCACCATCCCAATG
TATAATTCAGGTGTCCTTA -> ATAATTCAGGTGTCCTTAT
TATAGGGGGGAGTTGCACC -> ATAGGGGGGAGTTGCACCC
TATAGGTATCCGTGATGAT -> ATAGGTATCCGTGATGATG
TATATCTGCGCAGCGCAAC -> ATATCTGCGCAGCGCAACC
TATATGAAATCGCTTTTGT -> ATATGAAATCGCTTTTGTT
TATCATTAGCAATAAATAA -> ATCATTAGCAATAAATAAT
TATCCGGCTCAATCACTAA -> ATCCGGCTCAATCACTAAT
TATCCGTGATGATGGACTA -> ATCCGTGATGATGGACTAC
TATCGCATTATCATTAGCA -> ATCGCATTATCATTAGCAA
TATCTCACGTAAATGAGAC -> ATCTCACGTAAATGAGACT
TATCTGCGCAGCGCAACCA -> ATCTGCGCAGCGCAACCAA
TATCTGTGAGTTATGACGT -> ATCTGTGAGTTATGACGTA
TATGAAATCGCTTTTGTTA -> ATGAAATCGCTTTTGTTAA
TATGACAGGTCCCAGAAGT -> ATGACAGGTCCCAGAAGTG
TATGACGTATAACCCACCA -> ATGACGTATAACCCACCAT
TATGAGAGGTTTGGCACGG -> ATGAGAGGTTTGGCACGGT
TATGATACATTTTCTGTAT -> ATGATACATTTTCTGTATG
TATGATTTTCGTGACAGTC -> ATGATTTTCGTGACAGTCC
TATGCAAAGAACGAACCCG -> ATGCAAAGAACGAACCCGG
TATGCCGCCAGACCGGTGA -> ATGCCGCCAGACCGGTGAG
TATGCGGCGCTGATCCTTG -> ATGCGGCGCTGATCCTTGC
TATGGAATCGGATCACTAG -> ATGGAATCGGATCACTAGT
TATGGAGCGGTCAACAGGG -> ATGGAGCGGTCAACAGGGA
TATGGCCGGTCACCATCTG -> ATGGCCGGTCACCATCTGG
TATGGTTTAAAAACGTTTG -> ATGGTTTAAAAACGTTTGA
TATGTATGGTTTAAAAACG -> ATGTATGGTTTAAAAACGT
TATGTCACACTATCGCATT -> ATGTCACACTATCGCATTA
TATTCACTGCATTTATGTA -> ATTCACTGCATTTATGTAT
TATTGGAAGTGTTTGACAC -> ATTGGAAGTGTTTGACACC
TATTTTGAAGGGCCGCTCA -> ATTTTGAAGGGCCGCTCAT
TCAAATGGGTCTGAGAGTT -> CAAATGGGTCTGAGAGTTG
TCAACAGGGAATGGTTAGG -> CAACAGGGAATGGTTAGGG
TCAACGTCGACTTCAGACG -> CAACGTCGACTTCAGACGA
TCAAGCATTCGTCTCCAAT -> CAAGCATTCGTCTCCAATA
TCAATCACTAATACCAATC -> CAATCACTAATACCAATCA
TCAATTGTTTACCATGGGC -> CAATTGTTTACCATGGGCG
TCACACTATCGCATTATCA -> CACACTATCGCATTATCAT
TCACCATCTGGAGCGGGAG -> CACCATCTGGAGCGGGAGT
TCACCCAGTGAGATTTGGC -> CACCCAGTGAGATTTGGCC
TCACGTAAATGAGACTATA -> CACGTAAATGAGACTATAA
TCACGTATGGCCGGTCACC -> CACGTATGGCCGGTCACCA
TCACTAATACCAATCACTT -> CACTAATACCAATCACTTG
TCACTAGTTTCACCCAGTG -> CACTAGTTTCACCCAGTGA
TCACTCCGAATTACACACA -> CACTCCGAATTACACACAA
TCACTGCATTTATGTATGG -> CACTGCATTTATGTATGGT
TCACTTGGCGACAATTACC -> CACTTGGCGACAATTACCA
TCAGACGACATGTTGATTT -> CAGACGACATGTTGATTTG
TCAGACGACCATTGCGCGT -> CAGACGACCATTGCGCGTG
TCAGACGACGAAATGTCGT -> CAGACGACGAAATGTCGTT
TCAGACGACTGATTCCTTA -> CAGACGACTGATTCCTTAC
TCAGAGGAATATAAACTCC -> CAGAGGAATATAAACTCCG
TCAGAGGACTCGCCGACAA -> CAGAGGACTCGCCGACAAA
TCAGAGGAGACGGTTACAC -> CAGAGGAGACGGTTACACT
TCAGATGTCGCCGTGTGTA -> CAGATGTCGCCGTGTGTAG
TCAGCAGGAGGCAAGGTCA -> CAGCAGGAGGCAAGGTCAG
TCAGCCTTGGTCTTCATGG -> CAGCCTTGGTCTTCATGGA
TCAGGAACCAGTCCACATA -> CAGGAACCAGTCCACATAG
TCAGGTGTCCTTATGGAAT -> CAGGTGTCCTTATGGAATC
TCATAACACGCTACCAGAC -> CATAACACGCTACCAGACC
TCATAACACTGATGGATGC -> CATAACACTGATGGATGCG
TCATACGTCGACTTCAGAC -> CATACGTCGACTTCAGACG
TCATATGATTTTCGTGACA -> CATATGATTTTCGTGACAG
TCATCCGATGAGCAAGATA -> CATCCGATGAGCAAGATAA
TCATCGACAATCTCAGAGG -> CATCGACAATCTCAGAGGA
TCATCGTAGGCACTTGAGT -> CATCGTAGGCACTTGAGTG
TCATGGATTGTCTGGTTCT -> CATGGATTGTCTGGTTCTG
TCATTAGCAATAAATAATT -> CATTAGCAATAAATAATTT
TCATTGGAGAGTAGAAGAA -> CATTGGAGAGTAGAAGAAA
TCCAAATAGTTCAAATGGG -> CCAAATAGTTCAAATGGGT
TCCAATACCTACTCTTCGC -> CCAATACCTACTCTTCGCC
TCCACACGAAGTATGGAGC -> CCACACGAAGTATGGAGCG
TCCACATAGTCAATTGTTT -> CCACATAGTCAATTGTTTA
TCCACCGAGTTACAGCCAA -> CCACCGAGTTACAGCCAAT
TCCACTAGCTATATCTGCG -> CCACTAGCTATATCTGCGC
TCCACTGAATAGAACCTAA -> CCACTGAATAGAACCTAAA
TCCCAATGTAATCAACGTC -> CCCAATGTAATCAACGTCG
TCCCAGAAGTGGCTACTTC -> CCCAGAAGTGGCTACTTCT
TCCCGGAAACTTCAGCAGG -> CCCGGAAACTTCAGCAGGA
TCCCGGGATATGCGGCGCT -> CCCGGGATATGCGGCGCTG
TCCCGTACATATTCACTGC -> CCCGTACATATTCACTGCA
TCCGAATTACACACAACAT -> CCGAATTACACACAACATG
TCCGACAACCGACAATTTG -> CCGACAACCGACAATTTGC
TCCGACCACTTTAAAAAAG -> CCGACCACTTTAAAAAAGT
TCCGACTCATCGACAATCT -> CCGACTCATCGACAATCTC
TCCGATGAGCAAGATAACT -> CCGATGAGCAAGATAACTG
TCCGCCAGGGTTCGTCTGA -> CCGCCAGGGTTCGTCTGAC
TCCGGATTCGATCTTATTT -> CCGGATTCGATCTTATTTT
TCCGGCTCAATCACTAATA -> CCGGCTCAATCACTAATAC
TCCGGGTACAAATCCAAAT -> CCGGGTACAAATCCAAATA
TCCGGTTTTTTGCCCTTTA -> CCGGTTTTTTGCCCTTTAA
TCCGTGATGATGGACTACA -> CCGTGATGATGGACTACAT
TCCGTGGCCACCGTTCCGG -> CCGTGGCCACCGTTCCGGG
TCCTGTACGGTAAACATCA -> CCTGTACGGTAAACATCAG
TCCTTACCCGCCAGGGTTC -> CCTTACCCGCCAGGGTTCG
TCCTTATGGAATCGGATCA -> CCTTATGGAATCGGATCAC
TCCTTCTTGCTCAGAGGAC -> CCTTCTTGCTCAGAGGACT
TCCTTGCCATCACTCCGAA -> CCTTGCCATCACTCCGAAT
TCGAACAAAGGAACTAATA -> CGAACAAAGGAACTAATAG
TCGACAATCTCAGAGGAGA -> CGACAATCTCAGAGGAGAC
TCGACTTCAGACGACATGT -> CGACTTCAGACGACATGTT
TCGACTTCAGACGACCATT -> CGACTTCAGACGACCATTG
TCGACTTCAGACGACGAAA -> CGACTTCAGACGACGAAAT
TCGACTTCAGACGACTGAT -> CGACTTCAGACGACTGATT
TCGAGCCGGTTCTAGTCTA -> CGAGCCGGTTCTAGTCTAG
TCGATCTTATTTTGAAGGG -> CGATCTTATTTTGAAGGGC
TCGATGGTGCCCGCTGATG -> CGATGGTGCCCGCTGATGC
TCGCAACCCACGGCGGACG -> CGCAACCCACGGCGGACGG
TCGCACTACGAGTAGGGGC -> CGCACTACGAGTAGGGGCC
TCGCACTGAGTGAATGCGA -> CGCACTGAGTGAATGCGAT
TCGCATTATCATTAGCAAT -> CGCATTATCATTAGCAATA
TCGCCGACAAAATAATAAC -> CGCCGACAAAATAATAACA
TCGCCGGGAAGGGCCTATC -> CGCCGGGAAGGGCCTATCC
TCGCCGTGTGTAGCACGCT -> CGCCGTGTGTAGCACGCTC
TCGCCTAGGCAAACCTGGG -> CGCCTAGGCAAACCTGGGA
TCGCTTTTGTTAATGGGAC -> CGCTTTTGTTAATGGGACT
TCGGACCCTCGTCGGTACA -> CGGACCCTCGTCGGTACAT
TCGGATCACTAGTTTCACC -> CGGATCACTAGTTTCACCC
TCGGCTAGCTGCACATATA -> CGGCTAGCTGCACATATAA
TCGGGGGAGTTCCGTGGCC -> CGGGGGAGTTCCGTGGCCA
TCGGTACATGGGGAACGGC -> CGGTACATGGGGAACGGCA
TCGGTCAGCCTTGGTCTTC -> CGGTCAGCCTTGGTCTTCA
TCGTAGGCACTTGAGTGGA -> CGTAGGCACTTGAGTGGAG
TCGTCGGTACATGGGGAAC -> CGTCGGTACATGGGGAACG
TCGTCTCCAATACCTACTC -> CGTCTCCAATACCTACTCT
TCGTCTGACCCAAGATGGC -> CGTCTGACCCAAGATGGCG
TCGTCTGACGCTCTTAGGT -> CGTCTGACGCTCTTAGGTT
TCGTCTGACGGTGGGTTCA -> CGTCTGACGGTGGGTTCAT
TCGTCTGACTCGCCTAGGC -> CGTCTGACTCGCCTAGGCA
TCGTGACAGTCCTGTACGG -> CGTGACAGTCCTGTACGGT
TCGTTCCGCCAGGGTTCGT -> CGTTCCGCCAGGGTTCGTC
TCTAGAATCTCCTTCTTGC -> CTAGAATCTCCTTCTTGCT
TCTAGCCGTAGGTTGATGG -> CTAGCCGTAGGTTGATGGC
TCTAGTCTAGAATCTCCTT -> CTAGTCTAGAATCTCCTTC
TCTCACGTAAATGAGACTA -> CTCACGTAAATGAGACTAT
TCTCAGAGGAGACGGTTAC -> CTCAGAGGAGACGGTTACA
TCTCATATGATTTTCGTGA -> CTCATATGATTTTCGTGAC
TCTCCAATACCTACTCTTC -> CTCCAATACCTACTCTTCG
TCTCCCGGGATATGCGGCG -> CTCCCGGGATATGCGGCGC
TCTCCGACTCATCGACAAT -> CTCCGACTCATCGACAATC
TCTCCTTCTTGCTCAGAGG -> CTCCTTCTTGCTCAGAGGA
TCTCGCACTACGAGTAGGG -> CTCGCACTACGAGTAGGGG
TCTGACCAGAGTACTCATA -> CTGACCAGAGTACTCATAA
TCTGACCCAAGATGGCGCT -> CTGACCCAAGATGGCGCTT
TCTGACGCTCTTAGGTTAT -> CTGACGCTCTTAGGTTATG
TCTGACGGTGGGTTCATAC -> CTGACGGTGGGTTCATACG
TCTGACTCGCCTAGGCAAA -> CTGACTCGCCTAGGCAAAC
TCTGAGAGTTGGGGTGGCA -> CTGAGAGTTGGGGTGGCAG
TCTGAGGATGCGACGCGAG -> CTGAGGATGCGACGCGAGA
TCTGCGCAGCGCAACCAAT -> CTGCGCAGCGCAACCAATT
TCTGGAACTAGACCCATTG -> CTGGAACTAGACCCATTGG
TCTGGAGCGGGAGTACTGC -> CTGGAGCGGGAGTACTGCT
TCTGTATGCAAAGAACGAA -> CTGTATGCAAAGAACGAAC
TCTGTGAGTTATGACGTAT -> CTGTGAGTTATGACGTATA
TCTTAGGTTATGCCGCCAG -> CTTAGGTTATGCCGCCAGA
TCTTATTTTGAAGGGCCGC -> CTTATTTTGAAGGGCCGCT
TCTTCATGGATTGTCTGGT -> CTTCATGGATTGTCTGGTT
TCTTCGCCGGGAAGGGCCT -> CTTCGCCGGGAAGGGCCTA
TCTTCTCATATGATTTTCG -> CTTCTCATATGATTTTCGT
TCTTGCTCAGAGGACTCGC -> CTTGCTCAGAGGACTCGCC
TCTTTAATAAACGCGTATG -> CTTTAATAAACGCGTATGT
TCTTTCTTTGTCACGTATG -> CTTTCTTTGTCACGTATGG
TCTTTGTCACGTATGGCCG -> CTTTGTCACGTATGGCCGG
TGAAAAAAGCCCATACGGG -> GAAAAAAGCCCATACGGGC
TGAAAGGCGGGCCGTGCGA -> GAAAGGCGGGCCGTGCGAA
TGAAATCGCTTTTGTTAAT -> GAAATCGCTTTTGTTAATG
TGAAATGGCTGCAACGTGT -> GAAATGGCTGCAACGTGTC
TGAACAACGAATCTTCTCA -> GAACAACGAATCTTCTCAT
TGAAGGGCCGCTCATCCGA -> GAAGGGCCGCTCATCCGAT
TGAATAGAACCTAAATGTC -> GAATAGAACCTAAATGTCT
TGAATGCGATGACGGTACA -> GAATGCGATGACGGTACAG
TGACACCAAAAGGCGGTCG -> GACACCAAAAGGCGGTCGG
TGACAGGTCCCAGAAGTGG -> GACAGGTCCCAGAAGTGGC
TGACAGTCCTGTACGGTAA -> GACAGTCCTGTACGGTAAA
TGACCAGAGTACTCATAAC -> GACCAGAGTACTCATAACA
TGACCCAAGATGGCGCTTG -> GACCCAAGATGGCGCTTGC
TGACGCTCTTAGGTTATGC -> GACGCTCTTAGGTTATGCC
TGACGGTACAGGAGATCTT -> GACGGTACAGGAGATCTTT
TGACGGTGGGTTCATACGT -> GACGGTGGGTTCATACGTC
TGACGTATAACCCACCATC -> GACGTATAACCCACCATCC
TGACTATGACAGGTCCCAG -> GACTATGACAGGTCCCAGA
TGACTCGCCTAGGCAAACC -> GACTCGCCTAGGCAAACCT
TGAGACTATAACAAGCTTT -> GAGACTATAACAAGCTTTC
TGAGAGGTTTGGCACGGTT -> GAGAGGTTTGGCACGGTTG
TGAGAGTTGGGGTGGCAGA -> GAGAGTTGGGGTGGCAGAG
TGAGATTTGGCCTCTGGAA -> GAGATTTGGCCTCTGGAAC
TGAGCAAGATAACTGCTAG -> GAGCAAGATAACTGCTAGT
TGAGCCCACTAAGTCCACT -> GAGCCCACTAAGTCCACTA
TGAGGATGCGACGCGAGAT -> GAGGATGCGACGCGAGATA
TGAGGCTGTACTGTGGGAA -> GAGGCTGTACTGTGGGAAA
TGAGTCCACTGAATAGAAC -> GAGTCCACTGAATAGAACC
TGAGTGAATGCGATGACGG -> GAGTGAATGCGATGACGGT
TGAGTGGAGGAAAAAACCA -> GAGTGGAGGAAAAAACCAT
TGAGTTATGACGTATAACC -> GAGTTATGACGTATAACCC
TGATACATTTTCTGTATGC -> GATACATTTTCTGTATGCA
TGATCCTTGCCATCACTCC -> GATCCTTGCCATCACTCCG
TGATCGAGCCGGTTCTAGT -> GATCGAGCCGGTTCTAGTC
TGATGATGGACTACATGGC -> GATGATGGACTACATGGCC
TGATGCTCATAACACGCTA -> GATGCTCATAACACGCTAC
TGATGGACTACATGGCCAT -> GATGGACTACATGGCCATG
TGATGGATGCGACTCTCCC -> GATGGATGCGACTCTCCCG
TGATGGCATCCGGATTCGA -> GATGGCATCCGGATTCGAT
TGATGTTTCTTTAATAAAC -> GATGTTTCTTTAATAAACG
TGATTCCTTACCCGCCAGG -> GATTCCTTACCCGCCAGGG
TGATTTGCCGCCAGGGTTC -> GATTTGCCGCCAGGGTTCG
TGATTTTCGTGACAGTCCT -> GATTTTCGTGACAGTCCTG
TGCAAAGAACGAACCCGGC -> GCAAAGAACGAACCCGGCA
TGCAACGTGTCGCACTGAG -> GCAACGTGTCGCACTGAGT
TGCACATATAATTCAGGTG -> GCACATATAATTCAGGTGT
TGCACCAAATACTAGACTC -> GCACCAAATACTAGACTCG
TGCACCCAATGGGGGACCG -> GCACCCAATGGGGGACCGA
TGCACGTCGACTTCAGACG -> GCACGTCGACTTCAGACGA
TGCATCGAACAAAGGAACT -> GCATCGAACAAAGGAACTA
TGCATTTATGTATGGTTTA -> GCATTTATGTATGGTTTAA
TGCCATCACTCCGAATTAC -> GCCATCACTCCGAATTACA
TGCCCGCTGATGCTCATAA -> GCCCGCTGATGCTCATAAC
TGCCCTTTAATCGGTCAGC -> GCCCTTTAATCGGTCAGCC
TGCCGCCAGACCGGTGAGT -> GCCGCCAGACCGGTGAGTC
TGCCGCCAGGGTTCGTCTG -> GCCGCCAGGGTTCGTCTGA,GCCGCCAGGGTTCGTCTGA
TGCGAAATGTATCTCACGT -> GCGAAATGTATCTCACGTA
TGCGACGCGAGATACGCCC -> GCGACGCGAGATACGCCCA
TGCGACTCTCCCGGGATAT -> GCGACTCTCCCGGGATATG
TGCGAGGGCAACCGAAACC -> GCGAGGGCAACCGAAACCG
TGCGATGACGGTACAGGAG -> GCGATGACGGTACAGGAGA
TGCGCAGCGCAACCAATTT -> GCGCAGCGCAACCAATTTC
TGCGCGTGCCGCCAGGGTT -> GCGCGTGCCGCCAGGGTTC
TGCGGAAACTCATCGTAGG -> GCGGAAACTCATCGTAGGC
TGCGGCGCTGATCCTTGCC -> GCGGCGCTGATCCTTGCCA
TGCTACTGATCGAGCCGGT -> GCTACTGATCGAGCCGGTT
TGCTAGTAGCTACAGGTGG -> GCTAGTAGCTACAGGTGGA
TGCTCAGAGGAATATAAAC -> GCTCAGAGGAATATAAACT
TGCTCAGAGGACTCGCCGA -> GCTCAGAGGACTCGCCGAC
TGCTCATAACACGCTACCA -> GCTCATAACACGCTACCAG
TGCTCCGACCACTTTAAAA -> GCTCCGACCACTTTAAAAA
TGCTGAAAGGCGGGCCGTG -> GCTGAAAGGCGGGCCGTGC
TGGAACTAGACCCATTGGT -> GGAACTAGACCCATTGGTC
TGGAAGTGTTTGACACCAA -> GGAAGTGTTTGACACCAAA
TGGAATACTTAAACAAATT -> GGAATACTTAAACAAATTT
TGGAATCGGATCACTAGTT -> GGAATCGGATCACTAGTTT
TGGACATCGATGGTGCCCG -> GGACATCGATGGTGCCCGC
TGGACTACATGGCCATGGA -> GGACTACATGGCCATGGAA
TGGAGAGTAGAAGAAAGAG -> GGAGAGTAGAAGAAAGAGA
TGGAGCGGGAGTACTGCTA -> GGAGCGGGAGTACTGCTAC
TGGAGCGGTCAACAGGGAA -> GGAGCGGTCAACAGGGAAT
TGGAGGAAAAAACCATCTG -> GGAGGAAAAAACCATCTGA
TGGATAGCTAATCCACCGA -> GGATAGCTAATCCACCGAG
TGGATGCGACTCTCCCGGG -> GGATGCGACTCTCCCGGGA
TGGCACGGTTGCACCAAAT -> GGCACGGTTGCACCAAATA
TGGCAGAGCACATGGCCAC -> GGCAGAGCACATGGCCACA
TGGCATCCGGATTCGATCT -> GGCATCCGGATTCGATCTT
TGGCCACAAGTGCGAGGGC -> GGCCACAAGTGCGAGGGCA
TGGCCACCGTTCCGGGTAC -> GGCCACCGTTCCGGGTACA
TGGCCATGGAATACTTAAA -> GGCCATGGAATACTTAAAC
TGGCCGCATTCGCAACCCA -> GGCCGCATTCGCAACCCAC
TGGCCGGTCACCATCTGGA -> GGCCGGTCACCATCTGGAG
TGGCCTCTGGAACTAGACC -> GGCCTCTGGAACTAGACCC
TGGCGACAATTACCAAAAA -> GGCGACAATTACCAAAAAG
TGGCGAGTTGAAAAAAGCC -> GGCGAGTTGAAAAAAGCCC
TGGCGCTTGCGGAAACTCA -> GGCGCTTGCGGAAACTCAT
TGGCTACTTCTCCGACTCA -> GGCTACTTCTCCGACTCAT
TGGCTGCAACGTGTCGCAC -> GGCTGCAACGTGTCGCACT
TGGGAAATTGTGGTTAGAC -> GGGAAATTGTGGTTAGACT
TGGGACACGAGTATGATAC -> GGGACACGAGTATGATACA
TGGGACTCCCGGAAACTTC -> GGGACTCCCGGAAACTTCA
TGGGCCTAACGACCGCGTG -> GGGCCTAACGACCGCGTGA
TGGGCGTATAGGGGGGAGT -> GGGCGTATAGGGGGGAGTT
TGGGGAACGGCAATCTAGC -> GGGGAACGGCAATCTAGCC
TGGGGGACCGATCGGCTAG -> GGGGGACCGATCGGCTAGC
TGGGGTGGCAGAGCACATG -> GGGGTGGCAGAGCACATGG
TGGGTCTGAGAGTTGGGGT -> GGGTCTGAGAGTTGGGGTG
TGGGTTCATACGTCGACTT -> GGGTTCATACGTCGACTTC
TGGTCCGACAACCGACAAT -> GGTCCGACAACCGACAATT
TGGTCTTCATGGATTGTCT -> GGTCTTCATGGATTGTCTG
TGGTGCCCGCTGATGCTCA -> GGTGCCCGCTGATGCTCAT
TGGTTAGACTAGATTTGCA -> GGTTAGACTAGATTTGCAC
TGGTTAGGGTGTTTGAAAT -> GGTTAGGGTGTTTGAAATG
TGGTTGTTGCTGAAAGGCG -> GGTTGTTGCTGAAAGGCGG
TGGTTTAAAAACGTTTGAG -> GGTTTAAAAACGTTTGAGG
TGTAATCAACGTCGACTTC -> GTAATCAACGTCGACTTCA
TGTACGGTAAACATCAGGA -> GTACGGTAAACATCAGGAA
TGTACTGTGGGAAATTGTG -> GTACTGTGGGAAATTGTGG
TGTAGCACGCTCATTGGAG -> GTAGCACGCTCATTGGAGA
TGTATCTCACGTAAATGAG -> GTATCTCACGTAAATGAGA
TGTATGCAAAGAACGAACC -> GTATGCAAAGAACGAACCC
TGTATGGTTTAAAAACGTT -> GTATGGTTTAAAAACGTTT
TGTCACACTATCGCATTAT -> GTCACACTATCGCATTATC
TGTCACGTATGGCCGGTCA -> GTCACGTATGGCCGGTCAC
TGTCCTTATGGAATCGGAT -> GTCCTTATGGAATCGGATC
TGTCGCACTGAGTGAATGC -> GTCGCACTGAGTGAATGCG
TGTCGCCGTGTGTAGCACG -> GTCGCCGTGTGTAGCACGC
TGTCGTTCCGCCAGGGTTC -> GTCGTTCCGCCAGGGTTCG
TGTCTGACCAGAGTACTCA -> GTCTGACCAGAGTACTCAT
TGTGAGTTATGACGTATAA -> GTGAGTTATGACGTATAAC
TGTGATGTTTCTTTAATAA -> GTGATGTTTCTTTAATAAA
TGTGGGAAATTGTGGTTAG -> GTGGGAAATTGTGGTTAGA
TGTGGTTAGACTAGATTTG -> GTGGTTAGACTAGATTTGC
TGTGTAGCACGCTCATTGG -> GTGTAGCACGCTCATTGGA
TGTTAATGGGACTCCCGGA -> GTTAATGGGACTCCCGGAA
TGTTGATTTGCCGCCAGGG -> GTTGATTTGCCGCCAGGGT
TGTTGCTGAAAGGCGGGCC -> GTTGCTGAAAGGCGGGCCG
TGTTTACCATGGGCGTATA -> GTTTACCATGGGCGTATAG
TGTTTCTTTAATAAACGCG -> GTTTCTTTAATAAACGCGT
TGTTTGAAATGGCTGCAAC -> GTTTGAAATGGCTGCAACG
TGTTTGACACCAAAAGGCG -> GTTTGACACCAAAAGGCGG
TTAAAAAAGTTTATCTGTG -> TAAAAAAGTTTATCTGTGA
TTAAAAACGTTTGAGGCTG -> TAAAAACGTTTGAGGCTGT
TTAAACAAATTTGGCGAGT -> TAAACAAATTTGGCGAGTT
TTAATAAACGCGTATGTCA -> TAATAAACGCGTATGTCAC
TTAATCGGTCAGCCTTGGT -> TAATCGGTCAGCCTTGGTC
TTAATGGGACTCCCGGAAA -> TAATGGGACTCCCGGAAAC
TTACACACAACATGGCCGC -> TACACACAACATGGCCGCA
TTACACTATTGGAAGTGTT -> TACACTATTGGAAGTGTTT
TTACAGCCAATAAACATGT -> TACAGCCAATAAACATGTG
TTACCAAAAAGCTGGGCCT -> TACCAAAAAGCTGGGCCTA
TTACCATGGGCGTATAGGG -> TACCATGGGCGTATAGGGG
TTACCCGCCAGGGTTCGTC -> TACCCGCCAGGGTTCGTCT
TTAGACTAGATTTGCACGT -> TAGACTAGATTTGCACGTC
TTAGCAATAAATAATTTTT -> TAGCAATAAATAATTTTTA
TTAGGGTGTTTGAAATGGC -> TAGGGTGTTTGAAATGGCT
TTAGGTTATGCCGCCAGAC -> TAGGTTATGCCGCCAGACC
TTATCATTAGCAATAAATA -> TATCATTAGCAATAAATAA
TTATCTGTGAGTTATGACG -> TATCTGTGAGTTATGACGT
TTATGACGTATAACCCACC -> TATGACGTATAACCCACCA
TTATGAGAGGTTTGGCACG -> TATGAGAGGTTTGGCACGG
TTATGCCGCCAGACCGGTG -> TATGCCGCCAGACCGGTGA
TTATGGAATCGGATCACTA -> TATGGAATCGGATCACTAG
TTATGTATGGTTTAAAAAC -> TATGTATGGTTTAAAAACG
TTATTTTGAAGGGCCGCTC -> TATTTTGAAGGGCCGCTCA
TTCAAATGGGTCTGAGAGT -> TCAAATGGGTCTGAGAGTT
TTCAAGCATTCGTCTCCAA -> TCAAGCATTCGTCTCCAAT
TTCACCCAGTGAGATTTGG -> TCACCCAGTGAGATTTGGC
TTCACTGCATTTATGTATG -> TCACTGCATTTATGTATGG
TTCAGACGACATGTTGATT -> TCAGACGACATGTTGATTT
TTCAGACGACCATTGCGCG -> TCAGACGACCATTGCGCGT
TTCAGACGACGAAATGTCG -> TCAGACGACGAAATGTCGT
TTCAGACGACTGATTCCTT -> TCAGACGACTGATTCCTTA
TTCAGCAGGAGGCAAGGTC -> TCAGCAGGAGGCAAGGTCA
TTCAGGTGTCCTTATGGAA -> TCAGGTGTCCTTATGGAAT
TTCATACGTCGACTTCAGA -> TCATACGTCGACTTCAGAC
TTCATGGATTGTCTGGTTC -> TCATGGATTGTCTGGTTCT
TTCCCGTACATATTCACTG -> TCCCGTACATATTCACTGC
TTCCGCCAGGGTTCGTCTG -> TCCGCCAGGGTTCGTCTGA
TTCCGGGTACAAATCCAAA -> TCCGGGTACAAATCCAAAT
TTCCGTGGCCACCGTTCCG -> TCCGTGGCCACCGTTCCGG
TTCCTTACCCGCCAGGGTT -> TCCTTACCCGCCAGGGTTC
TTCGATCTTATTTTGAAGG -> TCGATCTTATTTTGAAGGG
TTCGCAACCCACGGCGGAC -> TCGCAACCCACGGCGGACG
TTCGCCGGGAAGGGCCTAT -> TCGCCGGGAAGGGCCTATC
TTCGTCTCCAATACCTACT -> TCGTCTCCAATACCTACTC
TTCGTCTGACCCAAGATGG -> TCGTCTGACCCAAGATGGC
TTCGTCTGACGCTCTTAGG -> TCGTCTGACGCTCTTAGGT
TTCGTCTGACGGTGGGTTC -> TCGTCTGACGGTGGGTTCA
TTCGTCTGACTCGCCTAGG -> TCGTCTGACTCGCCTAGGC
TTCGTGACAGTCCTGTACG -> TCGTGACAGTCCTGTACGG
TTCTAGTCTAGAATCTCCT -> TCTAGTCTAGAATCTCCTT
TTCTCATATGATTTTCGTG -> TCTCATATGATTTTCGTGA
TTCTCCGACTCATCGACAA -> TCTCCGACTCATCGACAAT
TTCTGTATGCAAAGAACGA -> TCTGTATGCAAAGAACGAA
TTCTTGCTCAGAGGACTCG -> TCTTGCTCAGAGGACTCGC
TTCTTTAATAAACGCGTAT -> TCTTTAATAAACGCGTATG
TTCTTTGTCACGTATGGCC -> TCTTTGTCACGTATGGCCG
TTGAAAAAAGCCCATACGG -> TGAAAAAAGCCCATACGGG
TTGAAATGGCTGCAACGTG -> TGAAATGGCTGCAACGTGT
TTGAACAACGAATCTTCTC -> TGAACAACGAATCTTCTCA
TTGAAGGGCCGCTCATCCG -> TGAAGGGCCGCTCATCCGA
TTGACACCAAAAGGCGGTC -> TGACACCAAAAGGCGGTCG
TTGAGGCTGTACTGTGGGA -> TGAGGCTGTACTGTGGGAA
TTGAGTGGAGGAAAAAACC -> TGAGTGGAGGAAAAAACCA
TTGATGGCATCCGGATTCG -> TGATGGCATCCGGATTCGA
TTGATTTGCCGCCAGGGTT -> TGATTTGCCGCCAGGGTTC
TTGCACCAAATACTAGACT -> TGCACCAAATACTAGACTC
TTGCACCCAATGGGGGACC -> TGCACCCAATGGGGGACCG
TTGCACGTCGACTTCAGAC -> TGCACGTCGACTTCAGACG
TTGCATCGAACAAAGGAAC -> TGCATCGAACAAAGGAACT
TTGCCATCACTCCGAATTA -> TGCCATCACTCCGAATTAC
TTGCCCTTTAATCGGTCAG -> TGCCCTTTAATCGGTCAGC
TTGCCGCCAGGGTTCGTCT -> TGCCGCCAGGGTTCGTCTG
TTGCGCGTGCCGCCAGGGT -> TGCGCGTGCCGCCAGGGTT
TTGCGGAAACTCATCGTAG -> TGCGGAAACTCATCGTAGG
TTGCTCAGAGGACTCGCCG -> TGCTCAGAGGACTCGCCGA
TTGCTGAAAGGCGGGCCGT -> TGCTGAAAGGCGGGCCGTG
TTGGAAGTGTTTGACACCA -> TGGAAGTGTTTGACACCAA
TTGGAGAGTAGAAGAAAGA -> TGGAGAGTAGAAGAAAGAG
TTGGCACGGTTGCACCAAA -> TGGCACGGTTGCACCAAAT
TTGGCCTCTGGAACTAGAC -> TGGCCTCTGGAACTAGACC
TTGGCGACAATTACCAAAA -> TGGCGACAATTACCAAAAA
TTGGCGAGTTGAAAAAAGC -> TGGCGAGTTGAAAAAAGCC
TTGGGGTGGCAGAGCACAT -> TGGGGTGGCAGAGCACATG
TTGGTCCGACAACCGACAA -> TGGTCCGACAACCGACAAT
TTGGTCTTCATGGATTGTC -> TGGTCTTCATGGATTGTCT
TTGTCACGTATGGCCGGTC -> TGTCACGTATGGCCGGTCA
TTGTGGTTAGACTAGATTT -> TGTGGTTAGACTAGATTTG
TTGTTAATGGGACTCCCGG -> TGTTAATGGGACTCCCGGA
TTGTTGCTGAAAGGCGGGC -> TGTTGCTGAAAGGCGGGCC
TTGTTTACCATGGGCGTAT -> TGTTTACCATGGGCGTATA
TTTAAAAAAGTTTATCTGT -> TTAAAAAAGTTTATCTGTG
TTTAAAAACGTTTGAGGCT -> TTAAAAACGTTTGAGGCTG
TTTAATAAACGCGTATGTC -> TTAATAAACGCGTATGTCA
TTTAATCGGTCAGCCTTGG -> TTAATCGGTCAGCCTTGGT
TTTACCATGGGCGTATAGG -> TTACCATGGGCGTATAGGG
TTTATCTGTGAGTTATGAC -> TTATCTGTGAGTTATGACG
TTTATGAGAGGTTTGGCAC -> TTATGAGAGGTTTGGCACG
TTTATGTATGGTTTAAAAA -> TTATGTATGGTTTAAAAAC
TTTCAAGCATTCGTCTCCA -> TTCAAGCATTCGTCTCCAA
TTTCACCCAGTGAGATTTG -> TTCACCCAGTGAGATTTGG
TTTCCCGTACATATTCACT -> TTCCCGTACATATTCACTG
TTTCGTGACAGTCCTGTAC -> TTCGTGACAGTCCTGTACG
TTTCTGTATGCAAAGAACG -> TTCTGTATGCAAAGAACGA
TTTCTTTAATAAACGCGTA -> TTCTTTAATAAACGCGTAT
TTTCTTTGTCACGTATGGC -> TTCTTTGTCACGTATGGCC
TTTGAAATGGCTGCAACGT -> TTGAAATGGCTGCAACGTG
TTTGAAGGGCCGCTCATCC -> TTGAAGGGCCGCTCATCCG
TTTGACACCAAAAGGCGGT -> TTGACACCAAAAGGCGGTC
TTTGAGGCTGTACTGTGGG -> TTGAGGCTGTACTGTGGGA
TTTGCACGTCGACTTCAGA -> TTGCACGTCGACTTCAGAC
TTTGCATCGAACAAAGGAA -> TTGCATCGAACAAAGGAAC
TTTGCCCTTTAATCGGTCA -> TTGCCCTTTAATCGGTCAG
TTTGCCGCCAGGGTTCGTC -> TTGCCGCCAGGGTTCGTCT
TTTGGCACGGTTGCACCAA -> TTGGCACGGTTGCACCAAA
TTTGGCCTCTGGAACTAGA -> TTGGCCTCTGGAACTAGAC
TTTGGCGAGTTGAAAAAAG -> TTGGCGAGTTGAAAAAAGC
TTTGTCACGTATGGCCGGT -> TTGTCACGTATGGCCGGTC
TTTGTTAATGGGACTCCCG -> TTGTTAATGGGACTCCCGG
TTTTATGAGAGGTTTGGCA -> TTTATGAGAGGTTTGGCAC
TTTTCGTGACAGTCCTGTA -> TTTCGTGACAGTCCTGTAC
TTTTCTGTATGCAAAGAAC -> TTTCTGTATGCAAAGAACG
TTTTGAAGGGCCGCTCATC -> TTTGAAGGGCCGCTCATCC
TTTTGCCCTTTAATCGGTC -> TTTGCCCTTTAATCGGTCA
TTTTGTTAATGGGACTCCC -> TTTGTTAATGGGACTCCCG
TTTTTATGAGAGGTTTGGC -> TTTTATGAGAGGTTTGGCA
TTTTTGCCCTTTAATCGGT -> TTTTGCCCTTTAATCGGTC
TTTTTTGCCCTTTAATCGG -> TTTTTGCCCTTTAATCGGT