AAAAACGGAAA->AAAACGGAAAG
AAAAAGCTATC->AAAAGCTATCG
AAAAAGCTATG->AAAAGCTATGC
AAAAAGGGGGC->AAAAGGGGGCG
AAAAATGTCGT->AAAATGTCGTA
AAAACGGAAAG->AAACGGAAAGA
AAAACGTCTGA->AAACGTCTGAA
AAAAGCAGTGC->AAAGCAGTGCG
AAAAGCTATCG->AAAGCTATCGA
AAAAGCTATGC->AAAGCTATGCT
AAAAGGGGGCG->AAAGGGGGCGT
AAAATATCTAC->AAATATCTACG
AAAATCGGGTG->AAATCGGGTGT
AAAATGTCGTA->AAATGTCGTAA
AAACGCCTGTC->AACGCCTGTCG
AAACGGAAAGA->AACGGAAAGAG
AAACGTCTGAA->AACGTCTGAAA
AAACTAGAGGA->AACTAGAGGAA
AAAGAGATTTA->AAGAGATTTAG
AAAGAGCACCA->AAGAGCACCAA
AAAGCAGTGCG->AAGCAGTGCGC
AAAGCTATCGA->AAGCTATCGAT
AAAGCTATGCT->AAGCTATGCTT
AAAGCTATTAT->AAGCTATTATC
AAAGGGGGCGT->AAGGGGGCGTG
AAATAAGTTTG->AATAAGTTTGA
AAATATACTTG->AATATACTTGC
AAATATCTACG->AATATCTACGA
AAATCGGGTGT->AATCGGGTGTT
AAATCTTTCGG->AATCTTTCGGA
AAATGCGGCGG->AATGCGGCGGA
AAATGTCGTAA->AATGTCGTAAG
AAATGTTTTAT->AATGTTTTATC
AACAAGAGTCT->ACAAGAGTCTT
AACATAGCGAA->ACATAGCGAAG
AACATGTGAAA->ACATGTGAAAA
AACCAGTGAAG->ACCAGTGAAGT
AACCCTGCGCG->ACCCTGCGCGA
AACCGTCGTAA->ACCGTCGTAAT
AACCGTTTCTG->ACCGTTTCTGG
AACGACATATT->ACGACATATTC
AACGCCTGTCG->ACGCCTGTCGG
AACGCGTACGT->ACGCGTACGTG
AACGGAAAGAG->ACGGAAAGAGA
AACGTAGTACG->ACGTAGTACGT
AACGTATATAA->ACGTATATAAC
AACGTCTGAAA->ACGTCTGAAAC
AACTAGAGGAA->ACTAGAGGAAA
AACTCGATGGG->ACTCGATGGGT
AACTCGTCCGC->ACTCGTCCGCC
AACTCTGGATT->ACTCTGGATTT
AACTGTCGGAC->ACTGTCGGACT
AACTGTTACCC->ACTGTTACCCT
AACTTCTCAGC->ACTTCTCAGCA
AACTTGCTGCC->ACTTGCTGCCG
AAGAAAAACGG->AGAAAAACGGA
AAGACAAGATT->AGACAAGATTA
AAGACATTCAA->AGACATTCAAT
AAGAGAAGGAC->AGAGAAGGACC
AAGAGATTTAG->AGAGATTTAGC
AAGAGCACCAA->AGAGCACCAAT
AAGAGCGGAAT->AGAGCGGAATC
AAGAGTCTTCC->AGAGTCTTCCG
AAGATCGATGA->AGATCGATGAG
AAGATTAAAGA->AGATTAAAGAG
AAGCAACGACA->AGCAACGACAT
AAGCACAATCA->AGCACAATCAG
AAGCACCCGAG->AGCACCCGAGC
AAGCACTTACA->AGCACTTACAT
AAGCAGTGCGC->AGCAGTGCGCT
AAGCGTATATT->AGCGTATATTT
AAGCTATCGAT->AGCTATCGATA
AAGCTATGCTT->AGCTATGCTTG
AAGCTATTATC->AGCTATTATCA
AAGCTTTGATC->AGCTTTGATCA
AAGGAATTCCT->AGGAATTCCTA
AAGGACCTGCA->AGGACCTGCAA
AAGGACTTGCA->AGGACTTGCAG
AAGGATACGGC->AGGATACGGCG
AAGGGACTAAG->AGGGACTAAGT
AAGGGGGCGAC->AGGGGGCGACT
AAGGGGGCGTG->AGGGGGCGTGA
AAGGTGCAACT->AGGTGCAACTT
AAGTACAGCAT->AGTACAGCATC
AAGTACGCACT->AGTACGCACTT
AAGTATCACCC->AGTATCACCCT
AAGTCGTACTG->AGTCGTACTGG
AAGTCGTGCCC->AGTCGTGCCCC
AAGTGACAACG->AGTGACAACGC
AAGTGACATTT->AGTGACATTTA
AAGTGGAAACG->AGTGGAAACGA
AAGTTGTCAAT->AGTTGTCAATG
AAGTTTAGCAC->AGTTTAGCACG
AAGTTTGACTA->AGTTTGACTAG
AATAAGAAAAA->ATAAGAAAAAC
AATAAGTTTGA->ATAAGTTTGAC
AATAGGAGCCT->ATAGGAGCCTC
AATAGGGTGTA->ATAGGGTGTAA
AATATACTTGC->ATATACTTGCT
AATATCTACGA->ATATCTACGAG
AATCAGGTCCT->ATCAGGTCCTG
AATCCTGTTAG->ATCCTGTTAGA
AATCGGGTGTT->ATCGGGTGTTT
AATCTGGGTAT->ATCTGGGTATG
AATCTTTCGGA->ATCTTTCGGAT
AATGACAGTGC->ATGACAGTGCG
AATGCATCAAG->ATGCATCAAGA
AATGCGGCGGA->ATGCGGCGGAA
AATGCGGGTCG->ATGCGGGTCGG
AATGCTTAACA->ATGCTTAACAA
AATGGCGTAAG->ATGGCGTAAGG
AATGTAGACCC->ATGTAGACCCA
AATGTATGTAG->ATGTATGTAGC
AATGTCGTAAG->ATGTCGTAAGA
AATGTGCACGA->ATGTGCACGAT
AATGTTGCCCT->ATGTTGCCCTA
AATGTTTCTCT->ATGTTTCTCTG
AATGTTTTATC->ATGTTTTATCA
AATGTTTTGGT->ATGTTTTGGTA
AATTACTACTT->ATTACTACTTC
AATTCCTATGA->ATTCCTATGAT
AATTCGTCCTT->ATTCGTCCTTA
AATTGGCGAAG->ATTGGCGAAGG
AATTGTCGATG->ATTGTCGATGA
AATTTGCACGG->ATTTGCACGGT
ACAACCAGTGA->CAACCAGTGAA
ACAACCGTCGT->CAACCGTCGTA
ACAACGCGTAC->CAACGCGTACG
ACAACTCGTCC->CAACTCGTCCG
ACAACTGTCGG->CAACTGTCGGA
ACAAGAGTCTT->CAAGAGTCTTC
ACAAGATTAAA->CAAGATTAAAG
ACAAGGATACG->CAAGGATACGG
ACAATAGGGTG->CAATAGGGTGT
ACAATCAGGTC->CAATCAGGTCC
ACAATGCTTAA->CAATGCTTAAC
ACACCAGGAGG->CACCAGGAGGG
ACACCTCCCTG->CACCTCCCTGT
ACACCTGAGAT->CACCTGAGATT
ACACGGCTAGC->CACGGCTAGCA
ACAGCATCGAC->CAGCATCGACA
ACAGTGCGGGT->CAGTGCGGGTG
ACATAGCGAAG->CATAGCGAAGT
ACATAGTATTT->CATAGTATTTG
ACATATTCCTC->CATATTCCTCC
ACATGCAGCAT->CATGCAGCATT
ACATGTGAAAA->CATGTGAAAAG
ACATTCAATAA->CATTCAATAAG
ACATTCCATAG->CATTCCATAGC
ACATTCGACTA->CATTCGACTAT
ACATTTACGGC->CATTTACGGCT
ACATTTGGACA->CATTTGGACAA
ACCAAGTGGAA->CCAAGTGGAAA
ACCAATGGCGT->CCAATGGCGTA
ACCACATGCAG->CCACATGCAGC
ACCAGGAGGGA->CCAGGAGGGAA
ACCAGTGAAGT->CCAGTGAAGTA
ACCAGTGTTCG->CCAGTGTTCGC
ACCATAAATAA->CCATAAATAAG
ACCCAAGCGTA->CCCAAGCGTAT
ACCCCCAAGTG->CCCCCAAGTGA
ACCCGAGCATC->CCCGAGCATCT
ACCCGCTTTCC->CCCGCTTTCCG
ACCCGGACCAG->CCCGGACCAGT
ACCCTACTGAA->CCCTACTGAAT
ACCCTGCGCGA->CCCTGCGCGAA
ACCCTTGAATT->CCCTTGAATTC
ACCGACAACCA->CCGACAACCAG
ACCGAGAAGTG->CCGAGAAGTGA
ACCGCCATACT->CCGCCATACTC
ACCGTCGGCGC->CCGTCGGCGCT
ACCGTCGTAAT->CCGTCGTAATG
ACCGTTTCTGG->CCGTTTCTGGA
ACCTCCCTGTC->CCTCCCTGTCT
ACCTCGCAATG->CCTCGCAATGT
ACCTGAGATTC->CCTGAGATTCC
ACCTGCAATCT->CCTGCAATCTG
ACCTTCGGACG->CCTTCGGACGC
ACGACATATTC->CGACATATTCC
ACGACTGATTG->CGACTGATTGG
ACGAGTTCATA->CGAGTTCATAG
ACGATAGTGCT->CGATAGTGCTA
ACGATGGACAC->CGATGGACACC
ACGCAATAGGA->CGCAATAGGAG
ACGCACTTGAA->CGCACTTGAAG
ACGCCGGGTAG->CGCCGGGTAGC
ACGCCTGTCGG->CGCCTGTCGGC
ACGCGTACGTG->CGCGTACGTGG
ACGCTATTCCT->CGCTATTCCTC
ACGCTGCGTAC->CGCTGCGTACC
ACGCTTAGCGC->CGCTTAGCGCA
ACGGAAAGAGA->CGGAAAGAGAT
ACGGCGGTACA->CGGCGGTACAA
ACGGCTAAGTC->CGGCTAAGTCG
ACGGCTAGCAA->CGGCTAGCAAA
ACGGGAGAGTA->CGGGAGAGTAG
ACGGTCGCGGT->CGGTCGCGGTT
ACGTAGTACGT->CGTAGTACGTG
ACGTATATAAC->CGTATATAACT
ACGTATTGGCG->CGTATTGGCGA
ACGTCCGCCCA->CGTCCGCCCAG
ACGTCTGAAAC->CGTCTGAAACG
ACGTGGCGACC->CGTGGCGACCA
ACGTGGGCACA->CGTGGGCACAT
ACGTTAGCTTC->CGTTAGCTTCC
ACGTTCTTTCT->CGTTCTTTCTT
ACTAAAACGTC->CTAAAACGTCT
ACTAAGTTGTC->CTAAGTTGTCA
ACTACTTCAGA->CTACTTCAGAA
ACTAGAGCGCG->CTAGAGCGCGA
ACTAGAGGAAA->CTAGAGGAAAA
ACTAGCTGTTT->CTAGCTGTTTA
ACTATAGATGA->CTATAGATGAG
ACTCGATGGGT->CTCGATGGGTG
ACTCGATTAGG->CTCGATTAGGA
ACTCGGGTCAG->CTCGGGTCAGG
ACTCGTCCGCC->CTCGTCCGCCC
ACTCTACCTCG->CTCTACCTCGC
ACTCTGGATTT->CTCTGGATTTA
ACTGAATGTTG->CTGAATGTTGC
ACTGATCGCTG->CTGATCGCTGC
ACTGATTGGGC->CTGATTGGGCC
ACTGCATATCT->CTGCATATCTT
ACTGCGCTTGG->CTGCGCTTGGC
ACTGGTGGCGA->CTGGTGGCGAA
ACTGTCGGACT->CTGTCGGACTA
ACTGTTACCCT->CTGTTACCCTT
ACTTACATTCC->CTTACATTCCA
ACTTCAGAAAA->CTTCAGAAAAT
ACTTCCGACGT->CTTCCGACGTT
ACTTCTCAGCA->CTTCTCAGCAA
ACTTGAAACTA->CTTGAAACTAG
ACTTGAAGCAC->CTTGAAGCACA
ACTTGCAGTCC->CTTGCAGTCCT
ACTTGCTCGGC->CTTGCTCGGCT
ACTTGCTGCCG->CTTGCTGCCGT
ACTTTGTACAT->CTTTGTACATT
AGAAAAACGGA->GAAAAACGGAA
AGAAAATATCT->GAAAATATCTA
AGAACGTATAT->GAACGTATATA
AGAAGCTTTGA->GAAGCTTTGAT
AGAAGGACCTG->GAAGGACCTGC
AGAAGGGACTA->GAAGGGACTAA
AGAAGTGACAA->GAAGTGACAAC
AGAATTACTAC->GAATTACTACT
AGACAAGATTA->GACAAGATTAA
AGACAAGGATA->GACAAGGATAC
AGACATTCAAT->GACATTCAATA
AGACCCAAGCG->GACCCAAGCGT
AGACGCTGCGT->GACGCTGCGTA
AGACTCTACCT->GACTCTACCTC
AGAGAAGGACC->GAGAAGGACCT
AGAGATTTAGC->GAGATTTAGCG
AGAGCACCAAT->GAGCACCAATG
AGAGCGACAAT->GAGCGACAATG
AGAGCGCGAGT->GAGCGCGAGTA
AGAGCGGAATC->GAGCGGAATCC
AGAGGAAAAAG->GAGGAAAAAGC
AGAGTAGCCTA->GAGTAGCCTAT
AGAGTCTTCCG->GAGTCTTCCGT
AGAGTGCTCAC->GAGTGCTCACA
AGATATCTTTG->GATATCTTTGA
AGATCATCAGT->GATCATCAGTT
AGATCGATGAG->GATCGATGAGG
AGATGAGAATT->GATGAGAATTA
AGATGCAAAAA->GATGCAAAAAG
AGATTAAAGAG->GATTAAAGAGC
AGATTAAGTTT->GATTAAGTTTA
AGATTCCGCTT->GATTCCGCTTG
AGATTTAGCGA->GATTTAGCGAG
AGCAAAGCTAT->GCAAAGCTATT
AGCAACGACAT->GCAACGACATA
AGCAATTTGCA->GCAATTTGCAC
AGCACAATCAG->GCACAATCAGG
AGCACCAATGG->GCACCAATGGC
AGCACCCGAGC->GCACCCGAGCA
AGCACGCCGGG->GCACGCCGGGT
AGCACTAGCTG->GCACTAGCTGT
AGCACTTACAT->GCACTTACATT
AGCAGCGTGGC->GCAGCGTGGCA
AGCAGCGTTGA->GCAGCGTTGAT
AGCAGTGCGCT->GCAGTGCGCTG
AGCATCGACAC->GCATCGACACG
AGCATCTCAAC->GCATCTCAACC
AGCATTCCACG->GCATTCCACGA
AGCCATGACTT->GCCATGACTTG
AGCCGAAATGC->GCCGAAATGCG
AGCCGGTATTA->GCCGGTATTAC
AGCCTATTAAT->GCCTATTAATT
AGCCTCTGGCC->GCCTCTGGCCC
AGCCTGCAGCA->GCCTGCAGCAG
AGCGAAGCAAC->GCGAAGCAACG
AGCGAAGTACA->GCGAAGTACAG
AGCGACAATGC->GCGACAATGCT
AGCGAGACAAG->GCGAGACAAGG
AGCGAGTCTAT->GCGAGTCTATC
AGCGCACCGAC->GCGCACCGACA
AGCGCGAGTAT->GCGCGAGTATG
AGCGGAATCCT->GCGGAATCCTG
AGCGTATATTT->GCGTATATTTC
AGCGTGGCAGG->GCGTGGCAGGA
AGCGTGGCTTA->GCGTGGCTTAT
AGCGTTGATTT->GCGTTGATTTC
AGCTAAGTACG->GCTAAGTACGC
AGCTATATGTT->GCTATATGTTC
AGCTATCGATA->GCTATCGATAG
AGCTATGCTTG->GCTATGCTTGC
AGCTATTATCA->GCTATTATCAG
AGCTCTGGCCT->GCTCTGGCCTC
AGCTGTTTACG->GCTGTTTACGC
AGCTTCCCGTC->GCTTCCCGTCA
AGCTTGCAGTC->GCTTGCAGTCA
AGCTTTCAGCT->GCTTTCAGCTA
AGCTTTGATCA->GCTTTGATCAT
AGGAAAAAGCT->GGAAAAAGCTA
AGGAAGCACCC->GGAAGCACCCG
AGGAATTCCTA->GGAATTCCTAT
AGGACATTTGG->GGACATTTGGA
AGGACCTGCAA->GGACCTGCAAT
AGGACTTGCAG->GGACTTGCAGT
AGGAGAAGCTT->GGAGAAGCTTT
AGGAGCCTCTG->GGAGCCTCTGG
AGGAGGGAATG->GGAGGGAATGT
AGGAGTGACCG->GGAGTGACCGT
AGGAGTGAGCT->GGAGTGAGCTC
AGGATACGGCG->GGATACGGCGG
AGGATTTAGGT->GGATTTAGGTA
AGGCCCCAATG->GGCCCCAATGT
AGGCCTTGAGT->GGCCTTGAGTG
AGGCGTGGAGC->GGCGTGGAGCT
AGGGAATGTTT->GGGAATGTTTC
AGGGACTAAGT->GGGACTAAGTT
AGGGCTAAAAA->GGGCTAAAAAT
AGGGGGCGACT->GGGGGCGACTT
AGGGGGCGTGA->GGGGGCGTGAG
AGGGTCCGTGG->GGGTCCGTGGC
AGGGTGTAATG->GGGTGTAATGC
AGGGTTACTTT->GGGTTACTTTG
AGGTAGGGCTA->GGTAGGGCTAA
AGGTCCTGAGA->GGTCCTGAGAT
AGGTCGTTACG->GGTCGTTACGT
AGGTGCAACTT->GGTGCAACTTG
AGGTGGATCGG->GGTGGATCGGA
AGGTTAAGAGA->GGTTAAGAGAA
AGTACAGCATC->GTACAGCATCG
AGTACGCACTT->GTACGCACTTG
AGTACGTGGGC->GTACGTGGGCA
AGTAGCCTATT->GTAGCCTATTA
AGTATCACCCT->GTATCACCCTA
AGTATGAGATA->GTATGAGATAT
AGTATTTGGGT->GTATTTGGGTT
AGTCATGGAGA->GTCATGGAGAT
AGTCCTCGGGT->GTCCTCGGGTA
AGTCGAGGAGT->GTCGAGGAGTG
AGTCGTACTGG->GTCGTACTGGT
AGTCGTGCCCC->GTCGTGCCCCC
AGTCTATCGGG->GTCTATCGGGT
AGTCTTCCGTT->GTCTTCCGTTA
AGTGAAGTATC->GTGAAGTATCA
AGTGACAACCG->GTGACAACCGT
AGTGACAACGC->GTGACAACGCG
AGTGACATTTA->GTGACATTTAC
AGTGACCGTCG->GTGACCGTCGG
AGTGAGCTCTG->GTGAGCTCTGG
AGTGCGCTGTT->GTGCGCTGTTT
AGTGCGGGTGC->GTGCGGGTGCT
AGTGCTAGGTC->GTGCTAGGTCG
AGTGCTCACAC->GTGCTCACACC
AGTGGAAACGA->GTGGAAACGAA
AGTGTTCGCGA->GTGTTCGCGAG
AGTTAACATAG->GTTAACATAGC
AGTTCATAGGC->GTTCATAGGCC
AGTTGGGCCCA->GTTGGGCCCAT
AGTTGTCAATG->GTTGTCAATGT
AGTTTAGCACG->GTTTAGCACGC
AGTTTGACTAG->GTTTGACTAGA
ATAAAAAGCTA->TAAAAAGCTAT
ATAAATAAGTT->TAAATAAGTTT
ATAACGTAGTA->TAACGTAGTAC
ATAACTGTTAC->TAACTGTTACC
ATAAGAAAAAC->TAAGAAAAACG
ATAAGTTTGAC->TAAGTTTGACT
ATACGGCGGTA->TACGGCGGTAC
ATACTCGGGTC->TACTCGGGTCA
ATACTGATCGC->TACTGATCGCT
ATACTTGCTCG->TACTTGCTCGG
ATAGATGAGAA->TAGATGAGAAT
ATAGCCGAAAT->TAGCCGAAATG
ATAGCGAAGTA->TAGCGAAGTAC
ATAGCTATATG->TAGCTATATGT
ATAGGAGCCTC->TAGGAGCCTCT
ATAGGCCCCAA->TAGGCCCCAAT
ATAGGGTGTAA->TAGGGTGTAAT
ATAGTATTTGG->TAGTATTTGGG
ATAGTGCTAGG->TAGTGCTAGGT
ATATAACTGTT->TATAACTGTTA
ATATACTTGCT->TATACTTGCTC
ATATATATTTT->TATATATTTTT
ATATATTTTTC->TATATTTTTCC
ATATCCAGGAG->TATCCAGGAGT
ATATCTACGAG->TATCTACGAGT
ATATCTTGCTT->TATCTTGCTTC
ATATCTTTGAT->TATCTTTGATA
ATATGTTCTGA->TATGTTCTGAG
ATATTCCTCCG->TATTCCTCCGG
ATATTCGGCGC->TATTCGGCGCC
ATATTTCCGCC->TATTTCCGCCG
ATATTTTTCCA->TATTTTTCCAG
ATCAAATCTTT->TCAAATCTTTC
ATCAAGAGCGG->TCAAGAGCGGA
ATCACCCTACT->TCACCCTACTG
ATCAGACGCTG->TCAGACGCTGC
ATCAGGTCCTG->TCAGGTCCTGA
ATCAGTTAACA->TCAGTTAACAT
ATCATCAGTTA->TCATCAGTTAA
ATCATGCCTCT->TCATGCCTCTT
ATCCAAGGGGG->TCCAAGGGGGC
ATCCAGGAGTG->TCCAGGAGTGA
ATCCTGTTAGA->TCCTGTTAGAT
ATCGACACGGC->TCGACACGGCT
ATCGATAGCCG->TCGATAGCCGA
ATCGATGAGGG->TCGATGAGGGT
ATCGCTGCGAT->TCGCTGCGATG
ATCGGAGACTC->TCGGAGACTCT
ATCGGGTATCG->TCGGGTATCGT
ATCGGGTGTTT->TCGGGTGTTTG
ATCGTCCGCCG->TCGTCCGCCGT
ATCTACGAGTT->TCTACGAGTTC
ATCTCAACCCT->TCTCAACCCTG
ATCTGGGTATG->TCTGGGTATGT
ATCTTGCTTCA->TCTTGCTTCAC
ATCTTTCGGAT->TCTTTCGGATG
ATCTTTGATAC->TCTTTGATACT
ATGAACTCGAT->TGAACTCGATG
ATGACAGTGCG->TGACAGTGCGG
ATGACTTGAAA->TGACTTGAAAC
ATGAGAATTAC->TGAGAATTACT
ATGAGATATCT->TGAGATATCTT
ATGAGGGTCCG->TGAGGGTCCGT
ATGAGGGTTAC->TGAGGGTTACT
ATGATTGGGGA->TGATTGGGGAG
ATGCAAAAAGG->TGCAAAAAGGG
ATGCAGCATTC->TGCAGCATTCC
ATGCATCAAGA->TGCATCAAGAG
ATGCCTCTTTG->TGCCTCTTTGC
ATGCGGCGGAA->TGCGGCGGAAA
ATGCGGGTCGG->TGCGGGTCGGA
ATGCTATATCC->TGCTATATCCA
ATGCTTAACAA->TGCTTAACAAG
ATGCTTGCCCT->TGCTTGCCCTA
ATGGACACCTC->TGGACACCTCC
ATGGAGATCAT->TGGAGATCATC
ATGGATTAGCC->TGGATTAGCCG
ATGGCGTAAGG->TGGCGTAAGGA
ATGGGTGCAGG->TGGGTGCAGGC
ATGTAGACCCA->TGTAGACCCAA
ATGTAGCTTGC->TGTAGCTTGCA
ATGTATGTAGC->TGTATGTAGCT
ATGTCGTAAGA->TGTCGTAAGAC
ATGTGAAAAGC->TGTGAAAAGCA
ATGTGCACGAT->TGTGCACGATA
ATGTGCGAGCA->TGTGCGAGCAC
ATGTTCTGAGC->TGTTCTGAGCG
ATGTTGCCCTA->TGTTGCCCTAT
ATGTTTCTCTG->TGTTTCTCTGA
ATGTTTTATCA->TGTTTTATCAA
ATGTTTTGGTA->TGTTTTGGTAA
ATTAAAGAGCA->TTAAAGAGCAC
ATTAAGTTTAG->TTAAGTTTAGC
ATTAATTGTCG->TTAATTGTCGA
ATTACTACTTC->TTACTACTTCA
ATTACTGCATA->TTACTGCATAT
ATTAGCCGGTA->TTAGCCGGTAT
ATTAGGATTTA->TTAGGATTTAG
ATTAGGTGGAT->TTAGGTGGATC
ATTATCAGACG->TTATCAGACGC
ATTCAATAAGA->TTCAATAAGAA
ATTCCACGATG->TTCCACGATGG
ATTCCATAGCT->TTCCATAGCTA
ATTCCGCTTGA->TTCCGCTTGAA
ATTCCTATGAT->TTCCTATGATT
ATTCCTCCGGA->TTCCTCCGGAA
ATTCCTCGCAC->TTCCTCGCACC
ATTCGACTATA->TTCGACTATAG
ATTCGGCGCCG->TTCGGCGCCGC
ATTCGTCCTTA->TTCGTCCTTAG
ATTGGCGAAGG->TTGGCGAAGGT
ATTGGCGAGCG->TTGGCGAGCGA
ATTGGGCCCTA->TTGGGCCCTAG
ATTGGGGAGTT->TTGGGGAGTTG
ATTGGTCGTTG->TTGGTCGTTGG
ATTGTCGATGA->TTGTCGATGAG
ATTTAAGATCG->TTTAAGATCGA
ATTTACGGCTA->TTTACGGCTAA
ATTTAGCGAGA->TTTAGCGAGAC
ATTTAGGTAGG->TTTAGGTAGGG
ATTTCACGACT->TTTCACGACTG
ATTTCCGCCGG->TTTCCGCCGGC
ATTTCTTTCAC->TTTCTTTCACA
ATTTGCACGGT->TTTGCACGGTC
ATTTGGACAAC->TTTGGACAACT
ATTTGGGTTTA->TTTGGGTTTAC
ATTTTTCCAGA->TTTTTCCAGAG
CAAAAAGGGGG->AAAAAGGGGGC
CAAAGCTATTA->AAAGCTATTAT
CAAATCTTTCG->AAATCTTTCGG
CAACATGTGAA->AACATGTGAAA
CAACCAGTGAA->AACCAGTGAAG
CAACCCTGCGC->AACCCTGCGCG
CAACCGTCGTA->AACCGTCGTAA
CAACGACATAT->AACGACATATT
CAACGCGTACG->AACGCGTACGT
CAACTCGTCCG->AACTCGTCCGC
CAACTCTGGAT->AACTCTGGATT
CAACTGTCGGA->AACTGTCGGAC
CAACTTGCTGC->AACTTGCTGCC
CAAGACATTCA->AAGACATTCAA
CAAGAGCGGAA->AAGAGCGGAAT
CAAGAGTCTTC->AAGAGTCTTCC
CAAGATTAAAG->AAGATTAAAGA
CAAGCGTATAT->AAGCGTATATT
CAAGGAATTCC->AAGGAATTCCT
CAAGGATACGG->AAGGATACGGC
CAAGGGGGCGA->AAGGGGGCGAC
CAAGTGACATT->AAGTGACATTT
CAAGTGGAAAC->AAGTGGAAACG
CAATAAGAAAA->AATAAGAAAAA
CAATAGGAGCC->AATAGGAGCCT
CAATAGGGTGT->AATAGGGTGTA
CAATCAGGTCC->AATCAGGTCCT
CAATCTGGGTA->AATCTGGGTAT
CAATGCTTAAC->AATGCTTAACA
CAATGGCGTAA->AATGGCGTAAG
CAATGTAGACC->AATGTAGACCC
CAATGTATGTA->AATGTATGTAG
CAATGTGCACG->AATGTGCACGA
CAATTTGCACG->AATTTGCACGG
CACAATCAGGT->ACAATCAGGTC
CACACCAGGAG->ACACCAGGAGG
CACACCTGAGA->ACACCTGAGAT
CACATAGTATT->ACATAGTATTT
CACATGCAGCA->ACATGCAGCAT
CACCAATGGCG->ACCAATGGCGT
CACCACATGCA->ACCACATGCAG
CACCAGGAGGG->ACCAGGAGGGA
CACCCGAGCAT->ACCCGAGCATC
CACCCGCTTTC->ACCCGCTTTCC
CACCCGGACCA->ACCCGGACCAG
CACCCTACTGA->ACCCTACTGAA
CACCGACAACC->ACCGACAACCA
CACCGAGAAGT->ACCGAGAAGTG
CACCTCCCTGT->ACCTCCCTGTC
CACCTGAGATT->ACCTGAGATTC
CACGACTGATT->ACGACTGATTG
CACGATAGTGC->ACGATAGTGCT
CACGATGGACA->ACGATGGACAC
CACGCCGGGTA->ACGCCGGGTAG
CACGCTTAGCG->ACGCTTAGCGC
CACGGCTAGCA->ACGGCTAGCAA
CACGGTCGCGG->ACGGTCGCGGT
CACTAGCTGTT->ACTAGCTGTTT
CACTTACATTC->ACTTACATTCC
CACTTGAAGCA->ACTTGAAGCAC
CAGAAAATATC->AGAAAATATCT
CAGACGCTGCG->AGACGCTGCGT
CAGAGCGACAA->AGAGCGACAAT
CAGCAATTTGC->AGCAATTTGCA
CAGCAGCGTGG->AGCAGCGTGGC
CAGCATCGACA->AGCATCGACAC
CAGCATTCCAC->AGCATTCCACG
CAGCGAAGCAA->AGCGAAGCAAC
CAGCGTGGCAG->AGCGTGGCAGG
CAGCGTTGATT->AGCGTTGATTT
CAGCTAAGTAC->AGCTAAGTACG
CAGGACATTTG->AGGACATTTGG
CAGGAGGGAAT->AGGAGGGAATG
CAGGAGTGAGC->AGGAGTGAGCT
CAGGCCTTGAG->AGGCCTTGAGT
CAGGTCCTGAG->AGGTCCTGAGA
CAGGTTAAGAG->AGGTTAAGAGA
CAGTCATGGAG->AGTCATGGAGA
CAGTCCTCGGG->AGTCCTCGGGT
CAGTCGAGGAG->AGTCGAGGAGT
CAGTGAAGTAT->AGTGAAGTATC
CAGTGCGCTGT->AGTGCGCTGTT
CAGTGCGGGTG->AGTGCGGGTGC
CAGTGTTCGCG->AGTGTTCGCGA
CAGTTAACATA->AGTTAACATAG
CATAAAAAGCT->ATAAAAAGCTA
CATAAATAAGT->ATAAATAAGTT
CATACTCGGGT->ATACTCGGGTC
CATAGCGAAGT->ATAGCGAAGTA
CATAGCTATAT->ATAGCTATATG
CATAGGCCCCA->ATAGGCCCCAA
CATAGTATTTG->ATAGTATTTGG
CATATATATTT->ATATATATTTT
CATATCTTGCT->ATATCTTGCTT
CATATTCCTCC->ATATTCCTCCG
CATATTCGGCG->ATATTCGGCGC
CATCAAGAGCG->ATCAAGAGCGG
CATCAGTTAAC->ATCAGTTAACA
CATCGACACGG->ATCGACACGGC
CATCTCAACCC->ATCTCAACCCT
CATGAACTCGA->ATGAACTCGAT
CATGACTTGAA->ATGACTTGAAA
CATGCAGCATT->ATGCAGCATTC
CATGCCTCTTT->ATGCCTCTTTG
CATGGAGATCA->ATGGAGATCAT
CATGTGAAAAG->ATGTGAAAAGC
CATTCAATAAG->ATTCAATAAGA
CATTCCACGAT->ATTCCACGATG
CATTCCATAGC->ATTCCATAGCT
CATTCGACTAT->ATTCGACTATA
CATTGGTCGTT->ATTGGTCGTTG
CATTTACGGCT->ATTTACGGCTA
CATTTGGACAA->ATTTGGACAAC
CCAAGCGTATA->CAAGCGTATAT
CCAAGGGGGCG->CAAGGGGGCGA
CCAAGTGACAT->CAAGTGACATT
CCAAGTGGAAA->CAAGTGGAAAC
CCAATGGCGTA->CAATGGCGTAA
CCAATGTGCAC->CAATGTGCACG
CCACATGCAGC->CACATGCAGCA
CCACCCGCTTT->CACCCGCTTTC
CCACGATGGAC->CACGATGGACA
CCAGAGCGACA->CAGAGCGACAA
CCAGCGAAGCA->CAGCGAAGCAA
CCAGGAGGGAA->CAGGAGGGAAT
CCAGGAGTGAG->CAGGAGTGAGC
CCAGTGAAGTA->CAGTGAAGTAT
CCAGTGTTCGC->CAGTGTTCGCG
CCATAAAAAGC->CATAAAAAGCT
CCATAAATAAG->CATAAATAAGT
CCATACTCGGG->CATACTCGGGT
CCATAGCTATA->CATAGCTATAT
CCATATTCGGC->CATATTCGGCG
CCATGAACTCG->CATGAACTCGA
CCATGACTTGA->CATGACTTGAA
CCCAAGCGTAT->CCAAGCGTATA
CCCAAGTGACA->CCAAGTGACAT
CCCAATGTGCA->CCAATGTGCAC
CCCAGCGAAGC->CCAGCGAAGCA
CCCATATTCGG->CCATATTCGGC
CCCATGAACTC->CCATGAACTCG
CCCCAAGTGAC->CCCAAGTGACA
CCCCAATGTGC->CCCAATGTGCA
CCCCCAAGTGA->CCCCAAGTGAC
CCCCCTCATAT->CCCCTCATATA
CCCCTACCCCC->CCCTACCCCCA
CCCCTCATATA->CCCTCATATAT
CCCGAGCATCT->CCGAGCATCTC
CCCGCTTTCCG->CCGCTTTCCGT
CCCGGACCAGT->CCGGACCAGTG
CCCGTCAACTC->CCGTCAACTCT
CCCTACCCCCA->CCTACCCCCAA
CCCTACGGGAG->CCTACGGGAGA
CCCTACTGAAT->CCTACTGAATG
CCCTAGAACGT->CCTAGAACGTA
CCCTATTTCTT->CCTATTTCTTT
CCCTCATATAT->CCTCATATATA
CCCTCCTCACG->CCTCCTCACGC
CCCTGCGCGAA->CCTGCGCGAAC
CCCTGTCTTGC->CCTGTCTTGCA
CCCTTGAATTC->CCTTGAATTCG
CCGAAATGCGG->CGAAATGCGGC
CCGACAACCAG->CGACAACCAGT
CCGACGTTAGC->CGACGTTAGCT
CCGAGAAGTGA->CGAGAAGTGAC
CCGAGCATCTC->CGAGCATCTCA
CCGCCATACTC->CGCCATACTCG
CCGCCCAGCGA->CGCCCAGCGAA
CCGCCCATGAA->CGCCCATGAAC
CCGCCGGCAGT->CGCCGGCAGTC
CCGCCGTACTC->CGCCGTACTCG
CCGCTAATGAC->CGCTAATGACA
CCGCTTGAAGC->CGCTTGAAGCA
CCGCTTTCCGT->CGCTTTCCGTA
CCGGAACCGTT->CGGAACCGTTT
CCGGACCAGTG->CGGACCAGTGT
CCGGCAGTCGA->CGGCAGTCGAG
CCGGGTAGCCA->CGGGTAGCCAT
CCGGTATTACT->CGGTATTACTG
CCGTACTCGAT->CGTACTCGATT
CCGTATTAGGT->CGTATTAGGTG
CCGTCAACTCT->CGTCAACTCTG
CCGTCCACCCG->CGTCCACCCGC
CCGTCGGCGCT->CGTCGGCGCTA
CCGTCGTAATG->CGTCGTAATGT
CCGTGGCATTG->CGTGGCATTGG
CCGTTAGGAAG->CGTTAGGAAGC
CCGTTTCTGGA->CGTTTCTGGAA
CCTACCCCCAA->CTACCCCCAAG
CCTACGGGAGA->CTACGGGAGAG
CCTACTGAATG->CTACTGAATGT
CCTAGAACGTA->CTAGAACGTAT
CCTATGATTGG->CTATGATTGGG
CCTATTAATTG->CTATTAATTGT
CCTATTTCTTT->CTATTTCTTTC
CCTCAACATGT->CTCAACATGTG
CCTCACGCTTA->CTCACGCTTAG
CCTCATATATA->CTCATATATAT
CCTCCCTGTCT->CTCCCTGTCTT
CCTCCGGAACC->CTCCGGAACCG
CCTCCTCACGC->CTCCTCACGCT
CCTCGCAATGT->CTCGCAATGTA
CCTCGCACCGA->CTCGCACCGAG
CCTCGGGTAAA->CTCGGGTAAAT
CCTCTGGCCCT->CTCTGGCCCTC
CCTCTTTGCAA->CTCTTTGCAAG
CCTGAGATGCA->CTGAGATGCAA
CCTGAGATTCC->CTGAGATTCCG
CCTGCAATCTG->CTGCAATCTGG
CCTGCAGCAGC->CTGCAGCAGCG
CCTGCGCGAAC->CTGCGCGAACT
CCTGTCGGCCC->CTGTCGGCCCC
CCTGTCTTGCA->CTGTCTTGCAA
CCTGTTAGATT->CTGTTAGATTA
CCTTAGAGTGC->CTTAGAGTGCT
CCTTCGGACGC->CTTCGGACGCA
CCTTGAATTCG->CTTGAATTCGT
CCTTGAGTGAC->CTTGAGTGACA
CGAAATATACT->GAAATATACTT
CGAAATGCGGC->GAAATGCGGCG
CGAACTTCTCA->GAACTTCTCAG
CGAAGCAACGA->GAAGCAACGAC
CGAAGGTGCAA->GAAGGTGCAAC
CGAAGTACAGC->GAAGTACAGCA
CGACAACCAGT->GACAACCAGTG
CGACAATGCTT->GACAATGCTTA
CGACACGGCTA->GACACGGCTAG
CGACATATTCC->GACATATTCCT
CGACCAAGTGG->GACCAAGTGGA
CGACGTTAGCT->GACGTTAGCTT
CGACTATAGAT->GACTATAGATG
CGACTGATTGG->GACTGATTGGG
CGACTTCCGAC->GACTTCCGACG
CGAGAAGGGAC->GAGAAGGGACT
CGAGAAGTGAC->GAGAAGTGACA
CGAGACAAGGA->GAGACAAGGAT
CGAGCACTAGC->GAGCACTAGCT
CGAGCATCTCA->GAGCATCTCAA
CGAGCGAGTCT->GAGCGAGTCTA
CGAGGAGTGAC->GAGGAGTGACC
CGAGTATGAGA->GAGTATGAGAT
CGAGTCTATCG->GAGTCTATCGG
CGAGTTCATAG->GAGTTCATAGG
CGATAGCCGAA->GATAGCCGAAA
CGATAGTGCTA->GATAGTGCTAG
CGATGAGGGTC->GATGAGGGTCC
CGATGAGGGTT->GATGAGGGTTA
CGATGGACACC->GATGGACACCT
CGATGGATTAG->GATGGATTAGC
CGATGGGTGCA->GATGGGTGCAG
CGATTAGGATT->GATTAGGATTT
CGCAATAGGAG->GCAATAGGAGC
CGCAATGTATG->GCAATGTATGT
CGCACCGACAA->GCACCGACAAC
CGCACCGAGAA->GCACCGAGAAG
CGCACTTGAAG->GCACTTGAAGC
CGCCATACTCG->GCCATACTCGG
CGCCCAGCGAA->GCCCAGCGAAG
CGCCCATGAAC->GCCCATGAACT
CGCCGCTAATG->GCCGCTAATGA
CGCCGGCAGTC->GCCGGCAGTCG
CGCCGGGTAGC->GCCGGGTAGCC
CGCCGTACTCG->GCCGTACTCGA
CGCCTGTCGGC->GCCTGTCGGCC
CGCGAACTTCT->GCGAACTTCTC
CGCGAGAAGGG->GCGAGAAGGGA
CGCGAGTATGA->GCGAGTATGAG
CGCGGTTGTGA->GCGGTTGTGAC
CGCGTACGTGG->GCGTACGTGGC
CGCTAATGACA->GCTAATGACAG
CGCTACGTATT->GCTACGTATTG
CGCTATTCCTC->GCTATTCCTCG
CGCTGCGATGG->GCTGCGATGGA
CGCTGCGTACC->GCTGCGTACCG
CGCTGTTTTGA->GCTGTTTTGAG
CGCTTAGCGCA->GCTTAGCGCAC
CGCTTGAAGCA->GCTTGAAGCAC
CGCTTGGCCAT->GCTTGGCCATA
CGCTTTCCGTA->GCTTTCCGTAT
CGGAAAATCGG->GGAAAATCGGG
CGGAAAGAGAT->GGAAAGAGATT
CGGAACCGTTT->GGAACCGTTTC
CGGAATCCTGT->GGAATCCTGTT
CGGAATGCATC->GGAATGCATCA
CGGACCAGTGT->GGACCAGTGTT
CGGACGCAATA->GGACGCAATAG
CGGACTAAAAC->GGACTAAAACG
CGGAGACTCTA->GGAGACTCTAC
CGGATGCTATA->GGATGCTATAT
CGGCAGTCGAG->GGCAGTCGAGG
CGGCCCCTACC->GGCCCCTACCC
CGGCGCCGCTA->GGCGCCGCTAA
CGGCGCTACGT->GGCGCTACGTA
CGGCGGAAAAT->GGCGGAAAATC
CGGCGGTACAA->GGCGGTACAAT
CGGCTAAGTCG->GGCTAAGTCGT
CGGCTAGCAAA->GGCTAGCAAAG
CGGCTAGCAGC->GGCTAGCAGCG
CGGGAGAGTAG->GGGAGAGTAGC
CGGGTAAATGT->GGGTAAATGTT
CGGGTAGCCAT->GGGTAGCCATG
CGGGTATCGTC->GGGTATCGTCC
CGGGTCAGGTT->GGGTCAGGTTA
CGGGTCGGAAT->GGGTCGGAATG
CGGGTGCTCTA->GGGTGCTCTAG
CGGGTGTTTGT->GGGTGTTTGTC
CGGTACAATAG->GGTACAATAGG
CGGTATTACTG->GGTATTACTGC
CGGTCGCGGTT->GGTCGCGGTTG
CGGTTGTGACA->GGTTGTGACAA
CGTAAGACAAG->GTAAGACAAGA
CGTAAGGACTT->GTAAGGACTTG
CGTAATGTTTT->GTAATGTTTTG
CGTACCGCCAT->GTACCGCCATA
CGTACGTGGCG->GTACGTGGCGA
CGTACTCGATT->GTACTCGATTA
CGTACTGGTGG->GTACTGGTGGC
CGTAGTACGTG->GTAGTACGTGG
CGTATATAACT->GTATATAACTG
CGTATATTTCC->GTATATTTCCG
CGTATTAGGTG->GTATTAGGTGG
CGTATTGGCGA->GTATTGGCGAG
CGTCAACTCTG->GTCAACTCTGG
CGTCCACCCGC->GTCCACCCGCT
CGTCCGCCCAG->GTCCGCCCAGC
CGTCCGCCCAT->GTCCGCCCATG
CGTCCGCCGTA->GTCCGCCGTAC
CGTCCTTAGAG->GTCCTTAGAGT
CGTCGGCGCTA->GTCGGCGCTAC
CGTCGTAATGT->GTCGTAATGTT
CGTCTGAAACG->GTCTGAAACGC
CGTGAGCCTGC->GTGAGCCTGCA
CGTGCCCCCTC->GTGCCCCCTCA
CGTGGAGCTTT->GTGGAGCTTTC
CGTGGCAGGAC->GTGGCAGGACA
CGTGGCATTGG->GTGGCATTGGT
CGTGGCGACCA->GTGGCGACCAA
CGTGGCTTATC->GTGGCTTATCC
CGTGGGCACAT->GTGGGCACATA
CGTTACGTTCT->GTTACGTTCTT
CGTTAGCTTCC->GTTAGCTTCCC
CGTTAGGAAGC->GTTAGGAAGCA
CGTTCTTTCTT->GTTCTTTCTTA
CGTTGATTTCA->GTTGATTTCAC
CGTTGGACTGC->GTTGGACTGCG
CGTTTCTGGAA->GTTTCTGGAAT
CTAAAAATGTC->TAAAAATGTCG
CTAAAACGTCT->TAAAACGTCTG
CTAAGTACGCA->TAAGTACGCAC
CTAAGTCGTGC->TAAGTCGTGCC
CTAAGTTGTCA->TAAGTTGTCAA
CTAATGACAGT->TAATGACAGTG
CTACCCCCAAG->TACCCCCAAGT
CTACCTCGCAA->TACCTCGCAAT
CTACGAGTTCA->TACGAGTTCAT
CTACGGGAGAG->TACGGGAGAGT
CTACGTATTGG->TACGTATTGGC
CTACTGAATGT->TACTGAATGTT
CTACTTCAGAA->TACTTCAGAAA
CTAGAACGTAT->TAGAACGTATA
CTAGAGCGCGA->TAGAGCGCGAG
CTAGAGGAAAA->TAGAGGAAAAA
CTAGCAAAGCT->TAGCAAAGCTA
CTAGCAGCGTT->TAGCAGCGTTG
CTAGCTGTTTA->TAGCTGTTTAC
CTAGGAGAAGC->TAGGAGAAGCT
CTAGGTCGTTA->TAGGTCGTTAC
CTATAGATGAG->TATAGATGAGA
CTATATCCAGG->TATATCCAGGA
CTATATGTTCT->TATATGTTCTG
CTATCGATAGC->TATCGATAGCC
CTATCGGGTAT->TATCGGGTATC
CTATGATTGGG->TATGATTGGGG
CTATGCTTGCC->TATGCTTGCCC
CTATTAATTGT->TATTAATTGTC
CTATTATCAGA->TATTATCAGAC
CTATTCCTCGC->TATTCCTCGCA
CTATTTCTTTC->TATTTCTTTCA
CTCAACATGTG->TCAACATGTGA
CTCAACCCTGC->TCAACCCTGCG
CTCACACCTGA->TCACACCTGAG
CTCACGCTTAG->TCACGCTTAGC
CTCAGCAATTT->TCAGCAATTTG
CTCATATATAT->TCATATATATT
CTCCCTGTCTT->TCCCTGTCTTG
CTCCGGAACCG->TCCGGAACCGT
CTCCTCACGCT->TCCTCACGCTT
CTCGATGGGTG->TCGATGGGTGC
CTCGATTAGGA->TCGATTAGGAT
CTCGCAATGTA->TCGCAATGTAT
CTCGCACCGAG->TCGCACCGAGA
CTCGGCTAGCA->TCGGCTAGCAG
CTCGGGTAAAT->TCGGGTAAATG
CTCGGGTCAGG->TCGGGTCAGGT
CTCGTCCGCCC->TCGTCCGCCCA
CTCTACCTCGC->TCTACCTCGCA
CTCTAGGAGAA->TCTAGGAGAAG
CTCTGATAACG->TCTGATAACGT
CTCTGGATTTA->TCTGGATTTAA
CTCTGGCCCTC->TCTGGCCCTCC
CTCTGGCCTCA->TCTGGCCTCAA
CTCTTTGCAAG->TCTTTGCAAGA
CTGAAACGCCT->TGAAACGCCTG
CTGAATGTTGC->TGAATGTTGCC
CTGAGATGCAA->TGAGATGCAAA
CTGAGATTCCG->TGAGATTCCGC
CTGAGCGTGGC->TGAGCGTGGCT
CTGATAACGTA->TGATAACGTAG
CTGATCGCTGC->TGATCGCTGCG
CTGATTGGGCC->TGATTGGGCCC
CTGCAATCTGG->TGCAATCTGGG
CTGCAGCAGCG->TGCAGCAGCGT
CTGCATATCTT->TGCATATCTTG
CTGCCGTCCAC->TGCCGTCCACC
CTGCGATGGAT->TGCGATGGATT
CTGCGCGAACT->TGCGCGAACTT
CTGCGCTTGGC->TGCGCTTGGCC
CTGCGTACCGC->TGCGTACCGCC
CTGGAATTGGC->TGGAATTGGCG
CTGGATTTAAG->TGGATTTAAGA
CTGGCCCTCCT->TGGCCCTCCTC
CTGGCCTCAAC->TGGCCTCAACA
CTGGGTATGTG->TGGGTATGTGC
CTGGTGGCGAA->TGGTGGCGAAA
CTGTCGGACTA->TGTCGGACTAA
CTGTCGGCCCC->TGTCGGCCCCT
CTGTCTTGCAA->TGTCTTGCAAG
CTGTTACCCTT->TGTTACCCTTG
CTGTTAGATTA->TGTTAGATTAA
CTGTTTACGCT->TGTTTACGCTA
CTGTTTTGAGG->TGTTTTGAGGC
CTTAACAAGAG->TTAACAAGAGT
CTTACATTCCA->TTACATTCCAT
CTTACGTCCGC->TTACGTCCGCC
CTTAGAGTGCT->TTAGAGTGCTC
CTTAGCGCACC->TTAGCGCACCG
CTTATCCAAGG->TTATCCAAGGG
CTTCACCACAT->TTCACCACATG
CTTCAGAAAAT->TTCAGAAAATA
CTTCCCGTCAA->TTCCCGTCAAC
CTTCCGACGTT->TTCCGACGTTA
CTTCCGTTAGG->TTCCGTTAGGA
CTTCGGACGCA->TTCGGACGCAA
CTTCTCAGCAA->TTCTCAGCAAT
CTTGAAACTAG->TTGAAACTAGA
CTTGAAGCACA->TTGAAGCACAA
CTTGAAGCACT->TTGAAGCACTT
CTTGAATTCGT->TTGAATTCGTC
CTTGAGTGACA->TTGAGTGACAA
CTTGCAAGGAA->TTGCAAGGAAT
CTTGCAGTCAT->TTGCAGTCATG
CTTGCAGTCCT->TTGCAGTCCTC
CTTGCCCTACG->TTGCCCTACGG
CTTGCTCGGCT->TTGCTCGGCTA
CTTGCTGCCGT->TTGCTGCCGTC
CTTGCTTCACC->TTGCTTCACCA
CTTGGCCATAA->TTGGCCATAAA
CTTTCACACCA->TTTCACACCAG
CTTTCAGCTAA->TTTCAGCTAAG
CTTTCCGTATT->TTTCCGTATTA
CTTTCGGATGC->TTTCGGATGCT
CTTTCTTACGT->TTTCTTACGTC
CTTTGATACTG->TTTGATACTGA
CTTTGATCATG->TTTGATCATGC
CTTTGCAAGAC->TTTGCAAGACA
CTTTGTACATT->TTTGTACATTC
GAAAAACGGAA->AAAAACGGAAA
GAAAAAGCTAT->AAAAAGCTATG
GAAAAGCAGTG->AAAAGCAGTGC
GAAAATATCTA->AAAATATCTAC
GAAAATCGGGT->AAAATCGGGTG
GAAACGCCTGT->AAACGCCTGTC
GAAACTAGAGG->AAACTAGAGGA
GAAAGAGATTT->AAAGAGATTTA
GAAATATACTT->AAATATACTTG
GAAATGCGGCG->AAATGCGGCGG
GAACCGTTTCT->AACCGTTTCTG
GAACGTATATA->AACGTATATAA
GAACTCGATGG->AACTCGATGGG
GAACTTCTCAG->AACTTCTCAGC
GAAGCAACGAC->AAGCAACGACA
GAAGCACAATC->AAGCACAATCA
GAAGCACCCGA->AAGCACCCGAG
GAAGCACTTAC->AAGCACTTACA
GAAGCTTTGAT->AAGCTTTGATC
GAAGGACCTGC->AAGGACCTGCA
GAAGGGACTAA->AAGGGACTAAG
GAAGGTGCAAC->AAGGTGCAACT
GAAGTACAGCA->AAGTACAGCAT
GAAGTATCACC->AAGTATCACCC
GAAGTGACAAC->AAGTGACAACG
GAATCCTGTTA->AATCCTGTTAG
GAATGCATCAA->AATGCATCAAG
GAATGTTGCCC->AATGTTGCCCT
GAATGTTTCTC->AATGTTTCTCT
GAATTACTACT->AATTACTACTT
GAATTCCTATG->AATTCCTATGA
GAATTCGTCCT->AATTCGTCCTT
GAATTGGCGAA->AATTGGCGAAG
GACAACCAGTG->ACAACCAGTGA
GACAACCGTCG->ACAACCGTCGT
GACAACGCGTA->ACAACGCGTAC
GACAACTCGTC->ACAACTCGTCC
GACAACTGTCG->ACAACTGTCGG
GACAAGATTAA->ACAAGATTAAA
GACAAGGATAC->ACAAGGATACG
GACAATGCTTA->ACAATGCTTAA
GACACCTCCCT->ACACCTCCCTG
GACACGGCTAG->ACACGGCTAGC
GACAGTGCGGG->ACAGTGCGGGT
GACATATTCCT->ACATATTCCTC
GACATTCAATA->ACATTCAATAA
GACATTTACGG->ACATTTACGGC
GACATTTGGAC->ACATTTGGACA
GACCAAGTGGA->ACCAAGTGGAA
GACCAGTGTTC->ACCAGTGTTCG
GACCCAAGCGT->ACCCAAGCGTA
GACCGTCGGCG->ACCGTCGGCGC
GACCTGCAATC->ACCTGCAATCT
GACGCAATAGG->ACGCAATAGGA
GACGCTGCGTA->ACGCTGCGTAC
GACGTTAGCTT->ACGTTAGCTTC
GACTAAAACGT->ACTAAAACGTC
GACTAAGTTGT->ACTAAGTTGTC
GACTAGAGCGC->ACTAGAGCGCG
GACTATAGATG->ACTATAGATGA
GACTCTACCTC->ACTCTACCTCG
GACTGATTGGG->ACTGATTGGGC
GACTGCGCTTG->ACTGCGCTTGG
GACTTCCGACG->ACTTCCGACGT
GACTTGAAACT->ACTTGAAACTA
GACTTGCAGTC->ACTTGCAGTCC
GAGAAGCTTTG->AGAAGCTTTGA
GAGAAGGACCT->AGAAGGACCTG
GAGAAGGGACT->AGAAGGGACTA
GAGAAGTGACA->AGAAGTGACAA
GAGAATTACTA->AGAATTACTAC
GAGACAAGGAT->AGACAAGGATA
GAGACTCTACC->AGACTCTACCT
GAGAGTAGCCT->AGAGTAGCCTA
GAGATATCTTT->AGATATCTTTG
GAGATCATCAG->AGATCATCAGT
GAGATGCAAAA->AGATGCAAAAA
GAGATTCCGCT->AGATTCCGCTT
GAGATTTAGCG->AGATTTAGCGA
GAGCACCAATG->AGCACCAATGG
GAGCACTAGCT->AGCACTAGCTG
GAGCATCTCAA->AGCATCTCAAC
GAGCCTCTGGC->AGCCTCTGGCC
GAGCCTGCAGC->AGCCTGCAGCA
GAGCGACAATG->AGCGACAATGC
GAGCGAGTCTA->AGCGAGTCTAT
GAGCGCGAGTA->AGCGCGAGTAT
GAGCGGAATCC->AGCGGAATCCT
GAGCGTGGCTT->AGCGTGGCTTA
GAGCTCTGGCC->AGCTCTGGCCT
GAGCTTTCAGC->AGCTTTCAGCT
GAGGAAAAAGC->AGGAAAAAGCT
GAGGAGTGACC->AGGAGTGACCG
GAGGCGTGGAG->AGGCGTGGAGC
GAGGGAATGTT->AGGGAATGTTT
GAGGGTCCGTG->AGGGTCCGTGG
GAGGGTTACTT->AGGGTTACTTT
GAGTAGCCTAT->AGTAGCCTATT
GAGTATGAGAT->AGTATGAGATA
GAGTCTATCGG->AGTCTATCGGG
GAGTCTTCCGT->AGTCTTCCGTT
GAGTGACAACC->AGTGACAACCG
GAGTGACCGTC->AGTGACCGTCG
GAGTGAGCTCT->AGTGAGCTCTG
GAGTGCTCACA->AGTGCTCACAC
GAGTTCATAGG->AGTTCATAGGC
GAGTTGGGCCC->AGTTGGGCCCA
GATAACGTAGT->ATAACGTAGTA
GATACGGCGGT->ATACGGCGGTA
GATACTGATCG->ATACTGATCGC
GATAGCCGAAA->ATAGCCGAAAT
GATAGTGCTAG->ATAGTGCTAGG
GATATCTTTGA->ATATCTTTGAT
GATCATCAGTT->ATCATCAGTTA
GATCATGCCTC->ATCATGCCTCT
GATCGATGAGG->ATCGATGAGGG
GATCGCTGCGA->ATCGCTGCGAT
GATCGGAGACT->ATCGGAGACTC
GATGAGAATTA->ATGAGAATTAC
GATGAGGGTCC->ATGAGGGTCCG
GATGAGGGTTA->ATGAGGGTTAC
GATGCAAAAAG->ATGCAAAAAGG
GATGCTATATC->ATGCTATATCC
GATGGACACCT->ATGGACACCTC
GATGGATTAGC->ATGGATTAGCC
GATGGGTGCAG->ATGGGTGCAGG
GATTAAAGAGC->ATTAAAGAGCA
GATTAAGTTTA->ATTAAGTTTAG
GATTAGCCGGT->ATTAGCCGGTA
GATTAGGATTT->ATTAGGATTTA
GATTCCGCTTG->ATTCCGCTTGA
GATTGGGCCCT->ATTGGGCCCTA
GATTGGGGAGT->ATTGGGGAGTT
GATTTAAGATC->ATTTAAGATCG
GATTTAGCGAG->ATTTAGCGAGA
GATTTAGGTAG->ATTTAGGTAGG
GATTTCACGAC->ATTTCACGACT
GCAAAAAGGGG->CAAAAAGGGGG
GCAAAGCTATT->CAAAGCTATTA
GCAACGACATA->CAACGACATAT
GCAACTTGCTG->CAACTTGCTGC
GCAAGACATTC->CAAGACATTCA
GCAAGGAATTC->CAAGGAATTCC
GCAATAGGAGC->CAATAGGAGCC
GCAATCTGGGT->CAATCTGGGTA
GCAATGTATGT->CAATGTATGTA
GCAATTTGCAC->CAATTTGCACG
GCACAATCAGG->CACAATCAGGT
GCACATAGTAT->CACATAGTATT
GCACCAATGGC->CACCAATGGCG
GCACCCGAGCA->CACCCGAGCAT
GCACCGACAAC->CACCGACAACC
GCACCGAGAAG->CACCGAGAAGT
GCACGATAGTG->CACGATAGTGC
GCACGCCGGGT->CACGCCGGGTA
GCACGGTCGCG->CACGGTCGCGG
GCACTAGCTGT->CACTAGCTGTT
GCACTTACATT->CACTTACATTC
GCACTTGAAGC->CACTTGAAGCA
GCAGCAGCGTG->CAGCAGCGTGG
GCAGCATTCCA->CAGCATTCCAC
GCAGCGTGGCA->CAGCGTGGCAG
GCAGCGTTGAT->CAGCGTTGATT
GCAGGACATTT->CAGGACATTTG
GCAGGCCTTGA->CAGGCCTTGAG
GCAGTCATGGA->CAGTCATGGAG
GCAGTCCTCGG->CAGTCCTCGGG
GCAGTCGAGGA->CAGTCGAGGAG
GCAGTGCGCTG->CAGTGCGCTGT
GCATATCTTGC->CATATCTTGCT
GCATCAAGAGC->CATCAAGAGCG
GCATCGACACG->CATCGACACGG
GCATCTCAACC->CATCTCAACCC
GCATTCCACGA->CATTCCACGAT
GCATTGGTCGT->CATTGGTCGTT
GCCATAAAAAG->CCATAAAAAGC
GCCATACTCGG->CCATACTCGGG
GCCATGACTTG->CCATGACTTGA
GCCCAGCGAAG->CCCAGCGAAGC
GCCCATATTCG->CCCATATTCGG
GCCCATGAACT->CCCATGAACTC
GCCCCAATGTG->CCCCAATGTGC
GCCCCCTCATA->CCCCCTCATAT
GCCCCTACCCC->CCCCTACCCCC
GCCCTACGGGA->CCCTACGGGAG
GCCCTAGAACG->CCCTAGAACGT
GCCCTATTTCT->CCCTATTTCTT
GCCCTCCTCAC->CCCTCCTCACG
GCCGAAATGCG->CCGAAATGCGG
GCCGCTAATGA->CCGCTAATGAC
GCCGGCAGTCG->CCGGCAGTCGA
GCCGGGTAGCC->CCGGGTAGCCA
GCCGGTATTAC->CCGGTATTACT
GCCGTACTCGA->CCGTACTCGAT
GCCGTCCACCC->CCGTCCACCCG
GCCTATTAATT->CCTATTAATTG
GCCTCAACATG->CCTCAACATGT
GCCTCTGGCCC->CCTCTGGCCCT
GCCTCTTTGCA->CCTCTTTGCAA
GCCTGCAGCAG->CCTGCAGCAGC
GCCTGTCGGCC->CCTGTCGGCCC
GCCTTGAGTGA->CCTTGAGTGAC
GCGAAATATAC->CGAAATATACT
GCGAACTTCTC->CGAACTTCTCA
GCGAAGCAACG->CGAAGCAACGA
GCGAAGGTGCA->CGAAGGTGCAA
GCGAAGTACAG->CGAAGTACAGC
GCGACAATGCT->CGACAATGCTT
GCGACCAAGTG->CGACCAAGTGG
GCGACTTCCGA->CGACTTCCGAC
GCGAGAAGGGA->CGAGAAGGGAC
GCGAGACAAGG->CGAGACAAGGA
GCGAGCACTAG->CGAGCACTAGC
GCGAGCGAGTC->CGAGCGAGTCT
GCGAGTATGAG->CGAGTATGAGA
GCGAGTCTATC->CGAGTCTATCG
GCGATGGATTA->CGATGGATTAG
GCGCACCGACA->CGCACCGACAA
GCGCCGCTAAT->CGCCGCTAATG
GCGCGAACTTC->CGCGAACTTCT
GCGCGAGTATG->CGCGAGTATGA
GCGCTACGTAT->CGCTACGTATT
GCGCTGTTTTG->CGCTGTTTTGA
GCGCTTGGCCA->CGCTTGGCCAT
GCGGAAAATCG->CGGAAAATCGG
GCGGAATCCTG->CGGAATCCTGT
GCGGCGGAAAA->CGGCGGAAAAT
GCGGGTCGGAA->CGGGTCGGAAT
GCGGGTGCTCT->CGGGTGCTCTA
GCGGTACAATA->CGGTACAATAG
GCGGTTGTGAC->CGGTTGTGACA
GCGTAAGGACT->CGTAAGGACTT
GCGTACCGCCA->CGTACCGCCAT
GCGTACGTGGC->CGTACGTGGCG
GCGTATATTTC->CGTATATTTCC
GCGTGAGCCTG->CGTGAGCCTGC
GCGTGGAGCTT->CGTGGAGCTTT
GCGTGGCAGGA->CGTGGCAGGAC
GCGTGGCTTAT->CGTGGCTTATC
GCGTTGATTTC->CGTTGATTTCA
GCTAAAAATGT->CTAAAAATGTC
GCTAAGTACGC->CTAAGTACGCA
GCTAAGTCGTG->CTAAGTCGTGC
GCTAATGACAG->CTAATGACAGT
GCTACGTATTG->CTACGTATTGG
GCTAGCAAAGC->CTAGCAAAGCT
GCTAGCAGCGT->CTAGCAGCGTT
GCTAGGTCGTT->CTAGGTCGTTA
GCTATATCCAG->CTATATCCAGG
GCTATATGTTC->CTATATGTTCT
GCTATCGATAG->CTATCGATAGC
GCTATGCTTGC->CTATGCTTGCC
GCTATTATCAG->CTATTATCAGA
GCTATTCCTCG->CTATTCCTCGC
GCTCACACCTG->CTCACACCTGA
GCTCGGCTAGC->CTCGGCTAGCA
GCTCTAGGAGA->CTCTAGGAGAA
GCTCTGGCCTC->CTCTGGCCTCA
GCTGCCGTCCA->CTGCCGTCCAC
GCTGCGATGGA->CTGCGATGGAT
GCTGCGTACCG->CTGCGTACCGC
GCTGTTTACGC->CTGTTTACGCT
GCTGTTTTGAG->CTGTTTTGAGG
GCTTAACAAGA->CTTAACAAGAG
GCTTAGCGCAC->CTTAGCGCACC
GCTTATCCAAG->CTTATCCAAGG
GCTTCACCACA->CTTCACCACAT
GCTTCCCGTCA->CTTCCCGTCAA
GCTTGAAGCAC->CTTGAAGCACT
GCTTGCAGTCA->CTTGCAGTCAT
GCTTGCCCTAC->CTTGCCCTACG
GCTTGGCCATA->CTTGGCCATAA
GCTTTCAGCTA->CTTTCAGCTAA
GCTTTCCGTAT->CTTTCCGTATT
GCTTTGATCAT->CTTTGATCATG
GGAAAAAGCTA->GAAAAAGCTAT
GGAAAATCGGG->GAAAATCGGGT
GGAAAGAGATT->GAAAGAGATTT
GGAACCGTTTC->GAACCGTTTCT
GGAAGCACCCG->GAAGCACCCGA
GGAATCCTGTT->GAATCCTGTTA
GGAATGCATCA->GAATGCATCAA
GGAATGTTTCT->GAATGTTTCTC
GGAATTCCTAT->GAATTCCTATG
GGAATTGGCGA->GAATTGGCGAA
GGACAACTGTC->GACAACTGTCG
GGACACCTCCC->GACACCTCCCT
GGACATTTGGA->GACATTTGGAC
GGACCAGTGTT->GACCAGTGTTC
GGACCTGCAAT->GACCTGCAATC
GGACGCAATAG->GACGCAATAGG
GGACTAAAACG->GACTAAAACGT
GGACTAAGTTG->GACTAAGTTGT
GGACTGCGCTT->GACTGCGCTTG
GGACTTGCAGT->GACTTGCAGTC
GGAGAAGCTTT->GAGAAGCTTTG
GGAGACTCTAC->GAGACTCTACC
GGAGAGTAGCC->GAGAGTAGCCT
GGAGATCATCA->GAGATCATCAG
GGAGCCTCTGG->GAGCCTCTGGC
GGAGCTTTCAG->GAGCTTTCAGC
GGAGGGAATGT->GAGGGAATGTT
GGAGTGACCGT->GAGTGACCGTC
GGAGTGAGCTC->GAGTGAGCTCT
GGAGTTGGGCC->GAGTTGGGCCC
GGATACGGCGG->GATACGGCGGT
GGATCGGAGAC->GATCGGAGACT
GGATGCTATAT->GATGCTATATC
GGATTAGCCGG->GATTAGCCGGT
GGATTTAAGAT->GATTTAAGATC
GGATTTAGGTA->GATTTAGGTAG
GGCACATAGTA->GCACATAGTAT
GGCAGGACATT->GCAGGACATTT
GGCAGTCGAGG->GCAGTCGAGGA
GGCATTGGTCG->GCATTGGTCGT
GGCCATAAAAA->GCCATAAAAAG
GGCCCATATTC->GCCCATATTCG
GGCCCCAATGT->GCCCCAATGTG
GGCCCCTACCC->GCCCCTACCCC
GGCCCTAGAAC->GCCCTAGAACG
GGCCCTCCTCA->GCCCTCCTCAC
GGCCTCAACAT->GCCTCAACATG
GGCCTTGAGTG->GCCTTGAGTGA
GGCGAAATATA->GCGAAATATAC
GGCGAAGGTGC->GCGAAGGTGCA
GGCGACCAAGT->GCGACCAAGTG
GGCGACTTCCG->GCGACTTCCGA
GGCGAGCGAGT->GCGAGCGAGTC
GGCGCCGCTAA->GCGCCGCTAAT
GGCGCTACGTA->GCGCTACGTAT
GGCGGAAAATC->GCGGAAAATCG
GGCGGTACAAT->GCGGTACAATA
GGCGTAAGGAC->GCGTAAGGACT
GGCGTGAGCCT->GCGTGAGCCTG
GGCGTGGAGCT->GCGTGGAGCTT
GGCTAAAAATG->GCTAAAAATGT
GGCTAAGTCGT->GCTAAGTCGTG
GGCTAGCAAAG->GCTAGCAAAGC
GGCTAGCAGCG->GCTAGCAGCGT
GGCTTATCCAA->GCTTATCCAAG
GGGAATGTTTC->GGAATGTTTCT
GGGACTAAGTT->GGACTAAGTTG
GGGAGAGTAGC->GGAGAGTAGCC
GGGAGTTGGGC->GGAGTTGGGCC
GGGCACATAGT->GGCACATAGTA
GGGCCCATATT->GGCCCATATTC
GGGCCCTAGAA->GGCCCTAGAAC
GGGCGACTTCC->GGCGACTTCCG
GGGCGTGAGCC->GGCGTGAGCCT
GGGCTAAAAAT->GGCTAAAAATG
GGGGAGTTGGG->GGGAGTTGGGC
GGGGCGACTTC->GGGCGACTTCC
GGGGCGTGAGC->GGGCGTGAGCC
GGGGGCGACTT->GGGGCGACTTC
GGGGGCGTGAG->GGGGCGTGAGC
GGGTAAATGTT->GGTAAATGTTT
GGGTAGCCATG->GGTAGCCATGA
GGGTATCGTCC->GGTATCGTCCG
GGGTATGTGCG->GGTATGTGCGA
GGGTCAGGTTA->GGTCAGGTTAA
GGGTCCGTGGC->GGTCCGTGGCA
GGGTCGGAATG->GGTCGGAATGC
GGGTGCAGGCC->GGTGCAGGCCT
GGGTGCTCTAG->GGTGCTCTAGG
GGGTGTAATGC->GGTGTAATGCG
GGGTGTTTGTC->GGTGTTTGTCA
GGGTTACTTTG->GGTTACTTTGT
GGGTTTACCAT->GGTTTACCATA
GGTAAATGTTT->GTAAATGTTTT
GGTAAGTCGTA->GTAAGTCGTAC
GGTACAATAGG->GTACAATAGGG
GGTAGCCATGA->GTAGCCATGAC
GGTAGGGCTAA->GTAGGGCTAAA
GGTATCGTCCG->GTATCGTCCGC
GGTATGTGCGA->GTATGTGCGAG
GGTATTACTGC->GTATTACTGCA
GGTCAGGTTAA->GTCAGGTTAAG
GGTCCGTGGCA->GTCCGTGGCAT
GGTCCTGAGAT->GTCCTGAGATG
GGTCGCGGTTG->GTCGCGGTTGT
GGTCGGAATGC->GTCGGAATGCA
GGTCGTTACGT->GTCGTTACGTT
GGTCGTTGGAC->GTCGTTGGACT
GGTGCAACTTG->GTGCAACTTGC
GGTGCAGGCCT->GTGCAGGCCTT
GGTGCTCTAGG->GTGCTCTAGGA
GGTGGATCGGA->GTGGATCGGAG
GGTGGCGAAAT->GTGGCGAAATA
GGTGTAATGCG->GTGTAATGCGG
GGTGTTTGTCA->GTGTTTGTCAC
GGTTAAGAGAA->GTTAAGAGAAG
GGTTACTTTGT->GTTACTTTGTA
GGTTGTGACAA->GTTGTGACAAC
GGTTTACCATA->GTTTACCATAA
GTAAATGTTTT->TAAATGTTTTA
GTAAGACAAGA->TAAGACAAGAT
GTAAGGACTTG->TAAGGACTTGC
GTAAGTCGTAC->TAAGTCGTACT
GTAATGCGGGT->TAATGCGGGTC
GTAATGTTTTG->TAATGTTTTGG
GTACAATAGGG->TACAATAGGGT
GTACAGCATCG->TACAGCATCGA
GTACATTCGAC->TACATTCGACT
GTACCGCCATA->TACCGCCATAC
GTACCTTCGGA->TACCTTCGGAC
GTACGCACTTG->TACGCACTTGA
GTACGTGGCGA->TACGTGGCGAC
GTACGTGGGCA->TACGTGGGCAC
GTACTCGATTA->TACTCGATTAG
GTACTGGTGGC->TACTGGTGGCG
GTAGACCCAAG->TAGACCCAAGC
GTAGCCATGAC->TAGCCATGACT
GTAGCCTATTA->TAGCCTATTAA
GTAGCTTGCAG->TAGCTTGCAGT
GTAGGGCTAAA->TAGGGCTAAAA
GTAGTACGTGG->TAGTACGTGGG
GTATATAACTG->TATATAACTGT
GTATATTTCCG->TATATTTCCGC
GTATCACCCTA->TATCACCCTAC
GTATCGTCCGC->TATCGTCCGCC
GTATGAGATAT->TATGAGATATC
GTATGTAGCTT->TATGTAGCTTG
GTATGTGCGAG->TATGTGCGAGC
GTATTACTGCA->TATTACTGCAT
GTATTAGGTGG->TATTAGGTGGA
GTATTGGCGAG->TATTGGCGAGC
GTATTTGGGTT->TATTTGGGTTT
GTCAACTCTGG->TCAACTCTGGA
GTCAATGTAGA->TCAATGTAGAC
GTCACCCGGAC->TCACCCGGACC
GTCAGGTTAAG->TCAGGTTAAGA
GTCATGGAGAT->TCATGGAGATC
GTCCACCCGCT->TCCACCCGCTT
GTCCGCCCAGC->TCCGCCCAGCG
GTCCGCCCATG->TCCGCCCATGA
GTCCGCCGTAC->TCCGCCGTACT
GTCCGTGGCAT->TCCGTGGCATT
GTCCTCGGGTA->TCCTCGGGTAA
GTCCTGAGATG->TCCTGAGATGC
GTCCTTAGAGT->TCCTTAGAGTG
GTCGAGGAGTG->TCGAGGAGTGA
GTCGATGAGGG->TCGATGAGGGT
GTCGCGGTTGT->TCGCGGTTGTG
GTCGGAATGCA->TCGGAATGCAT
GTCGGACTAAA->TCGGACTAAAA
GTCGGCCCCTA->TCGGCCCCTAC
GTCGGCGCTAC->TCGGCGCTACG
GTCGTAAGACA->TCGTAAGACAA
GTCGTAATGTT->TCGTAATGTTT
GTCGTACTGGT->TCGTACTGGTG
GTCGTGCCCCC->TCGTGCCCCCT
GTCGTTACGTT->TCGTTACGTTC
GTCGTTGGACT->TCGTTGGACTG
GTCTATCGGGT->TCTATCGGGTA
GTCTGAAACGC->TCTGAAACGCC
GTCTTCCGTTA->TCTTCCGTTAG
GTCTTGCAAGG->TCTTGCAAGGA
GTGAAAAGCAG->TGAAAAGCAGT
GTGAAGTATCA->TGAAGTATCAC
GTGACAACCGT->TGACAACCGTC
GTGACAACGCG->TGACAACGCGT
GTGACAACTCG->TGACAACTCGT
GTGACATTTAC->TGACATTTACG
GTGACCGTCGG->TGACCGTCGGC
GTGAGCCTGCA->TGAGCCTGCAG
GTGAGCTCTGG->TGAGCTCTGGC
GTGCAACTTGC->TGCAACTTGCT
GTGCACGATAG->TGCACGATAGT
GTGCAGGCCTT->TGCAGGCCTTG
GTGCCCCCTCA->TGCCCCCTCAT
GTGCGAGCACT->TGCGAGCACTA
GTGCGCTGTTT->TGCGCTGTTTT
GTGCGGGTGCT->TGCGGGTGCTC
GTGCTAGGTCG->TGCTAGGTCGT
GTGCTCACACC->TGCTCACACCT
GTGCTCTAGGA->TGCTCTAGGAG
GTGGAAACGAA->TGGAAACGAAA
GTGGAGCTTTC->TGGAGCTTTCA
GTGGATCGGAG->TGGATCGGAGA
GTGGCAGGACA->TGGCAGGACAT
GTGGCATTGGT->TGGCATTGGTC
GTGGCGAAATA->TGGCGAAATAT
GTGGCGACCAA->TGGCGACCAAG
GTGGCTTATCC->TGGCTTATCCA
GTGGGCACATA->TGGGCACATAG
GTGTAATGCGG->TGTAATGCGGG
GTGTTCGCGAG->TGTTCGCGAGA
GTGTTTGTCAC->TGTTTGTCACC
GTTAACATAGC->TTAACATAGCG
GTTAAGAGAAG->TTAAGAGAAGG
GTTACCCTTGA->TTACCCTTGAA
GTTACGTTCTT->TTACGTTCTTT
GTTACTTTGTA->TTACTTTGTAC
GTTAGATTAAG->TTAGATTAAGT
GTTAGCTTCCC->TTAGCTTCCCG
GTTAGGAAGCA->TTAGGAAGCAC
GTTCATAGGCC->TTCATAGGCCC
GTTCGCGAGAA->TTCGCGAGAAG
GTTCTGAGCGT->TTCTGAGCGTG
GTTCTTTCTTA->TTCTTTCTTAC
GTTGATTTCAC->TTGATTTCACG
GTTGCCCTATT->TTGCCCTATTT
GTTGGACTGCG->TTGGACTGCGC
GTTGGGCCCAT->TTGGGCCCATA
GTTGTCAATGT->TTGTCAATGTA
GTTGTGACAAC->TTGTGACAACT
GTTTACCATAA->TTTACCATAAA
GTTTACGCTAT->TTTACGCTATT
GTTTAGCACGC->TTTAGCACGCC
GTTTCTCTGAT->TTTCTCTGATA
GTTTCTGGAAT->TTTCTGGAATT
GTTTGACTAGA->TTTGACTAGAG
GTTTGTCACCC->TTTGTCACCCG
GTTTTATCAAA->TTTTATCAAAT
GTTTTGAGGCG->TTTTGAGGCGT
GTTTTGGTAAG->TTTTGGTAAGT
TAAAAAGCTAT->AAAAAGCTATC
TAAAAATGTCG->AAAAATGTCGT
TAAAACGTCTG->AAAACGTCTGA
TAAAGAGCACC->AAAGAGCACCA
TAAATAAGTTT->AAATAAGTTTG
TAAATGTTTTA->AAATGTTTTAT
TAACAAGAGTC->AACAAGAGTCT
TAACATAGCGA->AACATAGCGAA
TAACGTAGTAC->AACGTAGTACG
TAACTGTTACC->AACTGTTACCC
TAAGAAAAACG->AAGAAAAACGG
TAAGACAAGAT->AAGACAAGATT
TAAGAGAAGGA->AAGAGAAGGAC
TAAGATCGATG->AAGATCGATGA
TAAGGACTTGC->AAGGACTTGCA
TAAGTACGCAC->AAGTACGCACT
TAAGTCGTACT->AAGTCGTACTG
TAAGTCGTGCC->AAGTCGTGCCC
TAAGTTGTCAA->AAGTTGTCAAT
TAAGTTTAGCA->AAGTTTAGCAC
TAAGTTTGACT->AAGTTTGACTA
TAATGACAGTG->AATGACAGTGC
TAATGCGGGTC->AATGCGGGTCG
TAATGTTTTGG->AATGTTTTGGT
TAATTGTCGAT->AATTGTCGATG
TACAATAGGGT->ACAATAGGGTG
TACAGCATCGA->ACAGCATCGAC
TACATTCCATA->ACATTCCATAG
TACATTCGACT->ACATTCGACTA
TACCATAAATA->ACCATAAATAA
TACCCCCAAGT->ACCCCCAAGTG
TACCCTTGAAT->ACCCTTGAATT
TACCGCCATAC->ACCGCCATACT
TACCTCGCAAT->ACCTCGCAATG
TACCTTCGGAC->ACCTTCGGACG
TACGAGTTCAT->ACGAGTTCATA
TACGCACTTGA->ACGCACTTGAA
TACGCTATTCC->ACGCTATTCCT
TACGGCGGTAC->ACGGCGGTACA
TACGGCTAAGT->ACGGCTAAGTC
TACGGGAGAGT->ACGGGAGAGTA
TACGTATTGGC->ACGTATTGGCG
TACGTCCGCCC->ACGTCCGCCCA
TACGTGGCGAC->ACGTGGCGACC
TACGTGGGCAC->ACGTGGGCACA
TACGTTCTTTC->ACGTTCTTTCT
TACTACTTCAG->ACTACTTCAGA
TACTCGATTAG->ACTCGATTAGG
TACTCGGGTCA->ACTCGGGTCAG
TACTGAATGTT->ACTGAATGTTG
TACTGATCGCT->ACTGATCGCTG
TACTGCATATC->ACTGCATATCT
TACTGGTGGCG->ACTGGTGGCGA
TACTTCAGAAA->ACTTCAGAAAA
TACTTGCTCGG->ACTTGCTCGGC
TACTTTGTACA->ACTTTGTACAT
TAGAACGTATA->AGAACGTATAT
TAGACCCAAGC->AGACCCAAGCG
TAGAGCGCGAG->AGAGCGCGAGT
TAGAGGAAAAA->AGAGGAAAAAG
TAGAGTGCTCA->AGAGTGCTCAC
TAGATGAGAAT->AGATGAGAATT
TAGATTAAGTT->AGATTAAGTTT
TAGCAAAGCTA->AGCAAAGCTAT
TAGCACGCCGG->AGCACGCCGGG
TAGCAGCGTTG->AGCAGCGTTGA
TAGCCATGACT->AGCCATGACTT
TAGCCGAAATG->AGCCGAAATGC
TAGCCGGTATT->AGCCGGTATTA
TAGCCTATTAA->AGCCTATTAAT
TAGCGAAGTAC->AGCGAAGTACA
TAGCGAGACAA->AGCGAGACAAG
TAGCGCACCGA->AGCGCACCGAC
TAGCTATATGT->AGCTATATGTT
TAGCTGTTTAC->AGCTGTTTACG
TAGCTTCCCGT->AGCTTCCCGTC
TAGCTTGCAGT->AGCTTGCAGTC
TAGGAAGCACC->AGGAAGCACCC
TAGGAGAAGCT->AGGAGAAGCTT
TAGGAGCCTCT->AGGAGCCTCTG
TAGGATTTAGG->AGGATTTAGGT
TAGGCCCCAAT->AGGCCCCAATG
TAGGGCTAAAA->AGGGCTAAAAA
TAGGGTGTAAT->AGGGTGTAATG
TAGGTAGGGCT->AGGTAGGGCTA
TAGGTCGTTAC->AGGTCGTTACG
TAGGTGGATCG->AGGTGGATCGG
TAGTACGTGGG->AGTACGTGGGC
TAGTATTTGGG->AGTATTTGGGT
TAGTGCTAGGT->AGTGCTAGGTC
TATAACTGTTA->ATAACTGTTAC
TATACTTGCTC->ATACTTGCTCG
TATAGATGAGA->ATAGATGAGAA
TATATAACTGT->ATATAACTGTT
TATATATTTTT->ATATATTTTTC
TATATCCAGGA->ATATCCAGGAG
TATATGTTCTG->ATATGTTCTGA
TATATTTCCGC->ATATTTCCGCC
TATATTTTTCC->ATATTTTTCCA
TATCAAATCTT->ATCAAATCTTT
TATCACCCTAC->ATCACCCTACT
TATCAGACGCT->ATCAGACGCTG
TATCCAAGGGG->ATCCAAGGGGG
TATCCAGGAGT->ATCCAGGAGTG
TATCGATAGCC->ATCGATAGCCG
TATCGGGTATC->ATCGGGTATCG
TATCGTCCGCC->ATCGTCCGCCG
TATCTACGAGT->ATCTACGAGTT
TATCTTGCTTC->ATCTTGCTTCA
TATCTTTGATA->ATCTTTGATAC
TATGAGATATC->ATGAGATATCT
TATGATTGGGG->ATGATTGGGGA
TATGCTTGCCC->ATGCTTGCCCT
TATGTAGCTTG->ATGTAGCTTGC
TATGTGCGAGC->ATGTGCGAGCA
TATGTTCTGAG->ATGTTCTGAGC
TATTAATTGTC->ATTAATTGTCG
TATTACTGCAT->ATTACTGCATA
TATTAGGTGGA->ATTAGGTGGAT
TATTATCAGAC->ATTATCAGACG
TATTCCTCCGG->ATTCCTCCGGA
TATTCCTCGCA->ATTCCTCGCAC
TATTCGGCGCC->ATTCGGCGCCG
TATTGGCGAGC->ATTGGCGAGCG
TATTTCCGCCG->ATTTCCGCCGG
TATTTCTTTCA->ATTTCTTTCAC
TATTTGGGTTT->ATTTGGGTTTA
TATTTTTCCAG->ATTTTTCCAGA
TCAAATCTTTC->CAAATCTTTCG
TCAACATGTGA->CAACATGTGAA
TCAACCCTGCG->CAACCCTGCGC
TCAACTCTGGA->CAACTCTGGAT
TCAAGAGCGGA->CAAGAGCGGAA
TCAATAAGAAA->CAATAAGAAAA
TCAATGTAGAC->CAATGTAGACC
TCACACCAGGA->CACACCAGGAG
TCACACCTGAG->CACACCTGAGA
TCACCACATGC->CACCACATGCA
TCACCCGGACC->CACCCGGACCA
TCACCCTACTG->CACCCTACTGA
TCACGACTGAT->CACGACTGATT
TCACGCTTAGC->CACGCTTAGCG
TCAGAAAATAT->CAGAAAATATC
TCAGACGCTGC->CAGACGCTGCG
TCAGCAATTTG->CAGCAATTTGC
TCAGCTAAGTA->CAGCTAAGTAC
TCAGGTCCTGA->CAGGTCCTGAG
TCAGGTTAAGA->CAGGTTAAGAG
TCAGTTAACAT->CAGTTAACATA
TCATAGGCCCC->CATAGGCCCCA
TCATATATATT->CATATATATTT
TCATCAGTTAA->CATCAGTTAAC
TCATGCCTCTT->CATGCCTCTTT
TCATGGAGATC->CATGGAGATCA
TCCAAGGGGGC->CCAAGGGGGCG
TCCACCCGCTT->CCACCCGCTTT
TCCACGATGGA->CCACGATGGAC
TCCAGAGCGAC->CCAGAGCGACA
TCCAGGAGTGA->CCAGGAGTGAG
TCCATAGCTAT->CCATAGCTATA
TCCCGTCAACT->CCCGTCAACTC
TCCCTGTCTTG->CCCTGTCTTGC
TCCGACGTTAG->CCGACGTTAGC
TCCGCCCAGCG->CCGCCCAGCGA
TCCGCCCATGA->CCGCCCATGAA
TCCGCCGGCAG->CCGCCGGCAGT
TCCGCCGTACT->CCGCCGTACTC
TCCGCTTGAAG->CCGCTTGAAGC
TCCGGAACCGT->CCGGAACCGTT
TCCGTATTAGG->CCGTATTAGGT
TCCGTGGCATT->CCGTGGCATTG
TCCGTTAGGAA->CCGTTAGGAAG
TCCTATGATTG->CCTATGATTGG
TCCTCACGCTT->CCTCACGCTTA
TCCTCCGGAAC->CCTCCGGAACC
TCCTCGCACCG->CCTCGCACCGA
TCCTCGGGTAA->CCTCGGGTAAA
TCCTGAGATGC->CCTGAGATGCA
TCCTGTTAGAT->CCTGTTAGATT
TCCTTAGAGTG->CCTTAGAGTGC
TCGACACGGCT->CGACACGGCTA
TCGACTATAGA->CGACTATAGAT
TCGAGGAGTGA->CGAGGAGTGAC
TCGATAGCCGA->CGATAGCCGAA
TCGATGAGGGT->CGATGAGGGTC,CGATGAGGGTT
TCGATGGGTGC->CGATGGGTGCA
TCGATTAGGAT->CGATTAGGATT
TCGCAATGTAT->CGCAATGTATG
TCGCACCGAGA->CGCACCGAGAA
TCGCGAGAAGG->CGCGAGAAGGG
TCGCGGTTGTG->CGCGGTTGTGA
TCGCTGCGATG->CGCTGCGATGG
TCGGAATGCAT->CGGAATGCATC
TCGGACGCAAT->CGGACGCAATA
TCGGACTAAAA->CGGACTAAAAC
TCGGAGACTCT->CGGAGACTCTA
TCGGATGCTAT->CGGATGCTATA
TCGGCCCCTAC->CGGCCCCTACC
TCGGCGCCGCT->CGGCGCCGCTA
TCGGCGCTACG->CGGCGCTACGT
TCGGCTAGCAG->CGGCTAGCAGC
TCGGGTAAATG->CGGGTAAATGT
TCGGGTATCGT->CGGGTATCGTC
TCGGGTCAGGT->CGGGTCAGGTT
TCGGGTGTTTG->CGGGTGTTTGT
TCGTAAGACAA->CGTAAGACAAG
TCGTAATGTTT->CGTAATGTTTT
TCGTACTGGTG->CGTACTGGTGG
TCGTCCGCCCA->CGTCCGCCCAT
TCGTCCGCCGT->CGTCCGCCGTA
TCGTCCTTAGA->CGTCCTTAGAG
TCGTGCCCCCT->CGTGCCCCCTC
TCGTTACGTTC->CGTTACGTTCT
TCGTTGGACTG->CGTTGGACTGC
TCTACCTCGCA->CTACCTCGCAA
TCTACGAGTTC->CTACGAGTTCA
TCTAGGAGAAG->CTAGGAGAAGC
TCTATCGGGTA->CTATCGGGTAT
TCTCAACCCTG->CTCAACCCTGC
TCTCAGCAATT->CTCAGCAATTT
TCTCTGATAAC->CTCTGATAACG
TCTGAAACGCC->CTGAAACGCCT
TCTGAGCGTGG->CTGAGCGTGGC
TCTGATAACGT->CTGATAACGTA
TCTGGAATTGG->CTGGAATTGGC
TCTGGATTTAA->CTGGATTTAAG
TCTGGCCCTCC->CTGGCCCTCCT
TCTGGCCTCAA->CTGGCCTCAAC
TCTGGGTATGT->CTGGGTATGTG
TCTTACGTCCG->CTTACGTCCGC
TCTTCCGTTAG->CTTCCGTTAGG
TCTTGCAAGGA->CTTGCAAGGAA
TCTTGCTTCAC->CTTGCTTCACC
TCTTTCACACC->CTTTCACACCA
TCTTTCGGATG->CTTTCGGATGC
TCTTTCTTACG->CTTTCTTACGT
TCTTTGATACT->CTTTGATACTG
TCTTTGCAAGA->CTTTGCAAGAC
TGAAAAGCAGT->GAAAAGCAGTG
TGAAACGCCTG->GAAACGCCTGT
TGAAACTAGAG->GAAACTAGAGG
TGAACTCGATG->GAACTCGATGG
TGAAGCACAAT->GAAGCACAATC
TGAAGCACTTA->GAAGCACTTAC
TGAAGTATCAC->GAAGTATCACC
TGAATGTTGCC->GAATGTTGCCC
TGAATTCGTCC->GAATTCGTCCT
TGACAACCGTC->GACAACCGTCG
TGACAACGCGT->GACAACGCGTA
TGACAACTCGT->GACAACTCGTC
TGACAGTGCGG->GACAGTGCGGG
TGACATTTACG->GACATTTACGG
TGACCGTCGGC->GACCGTCGGCG
TGACTAGAGCG->GACTAGAGCGC
TGACTTGAAAC->GACTTGAAACT
TGAGAATTACT->GAGAATTACTA
TGAGATATCTT->GAGATATCTTT
TGAGATGCAAA->GAGATGCAAAA
TGAGATTCCGC->GAGATTCCGCT
TGAGCCTGCAG->GAGCCTGCAGC
TGAGCGTGGCT->GAGCGTGGCTT
TGAGCTCTGGC->GAGCTCTGGCC
TGAGGCGTGGA->GAGGCGTGGAG
TGAGGGTCCGT->GAGGGTCCGTG
TGAGGGTTACT->GAGGGTTACTT
TGAGTGACAAC->GAGTGACAACC
TGATAACGTAG->GATAACGTAGT
TGATACTGATC->GATACTGATCG
TGATCATGCCT->GATCATGCCTC
TGATCGCTGCG->GATCGCTGCGA
TGATTGGGCCC->GATTGGGCCCT
TGATTGGGGAG->GATTGGGGAGT
TGATTTCACGA->GATTTCACGAC
TGCAAAAAGGG->GCAAAAAGGGG
TGCAACTTGCT->GCAACTTGCTG
TGCAAGACATT->GCAAGACATTC
TGCAAGGAATT->GCAAGGAATTC
TGCAATCTGGG->GCAATCTGGGT
TGCACGATAGT->GCACGATAGTG
TGCACGGTCGC->GCACGGTCGCG
TGCAGCAGCGT->GCAGCAGCGTG
TGCAGCATTCC->GCAGCATTCCA
TGCAGGCCTTG->GCAGGCCTTGA
TGCAGTCATGG->GCAGTCATGGA
TGCAGTCCTCG->GCAGTCCTCGG
TGCATATCTTG->GCATATCTTGC
TGCATCAAGAG->GCATCAAGAGC
TGCCCCCTCAT->GCCCCCTCATA
TGCCCTACGGG->GCCCTACGGGA
TGCCCTATTTC->GCCCTATTTCT
TGCCGTCCACC->GCCGTCCACCC
TGCCTCTTTGC->GCCTCTTTGCA
TGCGAGCACTA->GCGAGCACTAG
TGCGATGGATT->GCGATGGATTA
TGCGCGAACTT->GCGCGAACTTC
TGCGCTGTTTT->GCGCTGTTTTG
TGCGCTTGGCC->GCGCTTGGCCA
TGCGGCGGAAA->GCGGCGGAAAA
TGCGGGTCGGA->GCGGGTCGGAA
TGCGGGTGCTC->GCGGGTGCTCT
TGCGTACCGCC->GCGTACCGCCA
TGCTAGGTCGT->GCTAGGTCGTT
TGCTATATCCA->GCTATATCCAG
TGCTCACACCT->GCTCACACCTG
TGCTCGGCTAG->GCTCGGCTAGC
TGCTCTAGGAG->GCTCTAGGAGA
TGCTGCCGTCC->GCTGCCGTCCA
TGCTTAACAAG->GCTTAACAAGA
TGCTTCACCAC->GCTTCACCACA
TGCTTGCCCTA->GCTTGCCCTAC
TGGAAACGAAA->GGAAACGAAAG
TGGAATTGGCG->GGAATTGGCGA
TGGACAACTGT->GGACAACTGTC
TGGACACCTCC->GGACACCTCCC
TGGACTGCGCT->GGACTGCGCTT
TGGAGATCATC->GGAGATCATCA
TGGAGCTTTCA->GGAGCTTTCAG
TGGATCGGAGA->GGATCGGAGAC
TGGATTAGCCG->GGATTAGCCGG
TGGATTTAAGA->GGATTTAAGAT
TGGCAGGACAT->GGCAGGACATT
TGGCATTGGTC->GGCATTGGTCG
TGGCCATAAAA->GGCCATAAAAA
TGGCCCTCCTC->GGCCCTCCTCA
TGGCCTCAACA->GGCCTCAACAT
TGGCGAAATAT->GGCGAAATATA
TGGCGAAGGTG->GGCGAAGGTGC
TGGCGACCAAG->GGCGACCAAGT
TGGCGAGCGAG->GGCGAGCGAGT
TGGCGTAAGGA->GGCGTAAGGAC
TGGCTTATCCA->GGCTTATCCAA
TGGGCACATAG->GGGCACATAGT
TGGGCCCATAT->GGGCCCATATT
TGGGCCCTAGA->GGGCCCTAGAA
TGGGGAGTTGG->GGGGAGTTGGG
TGGGTATGTGC->GGGTATGTGCG
TGGGTGCAGGC->GGGTGCAGGCC
TGGGTTTACCA->GGGTTTACCAT
TGGTAAGTCGT->GGTAAGTCGTA
TGGTCGTTGGA->GGTCGTTGGAC
TGGTGGCGAAA->GGTGGCGAAAT
TGTAATGCGGG->GTAATGCGGGT
TGTACATTCGA->GTACATTCGAC
TGTACCTTCGG->GTACCTTCGGA
TGTAGACCCAA->GTAGACCCAAG
TGTAGCTTGCA->GTAGCTTGCAG
TGTATGTAGCT->GTATGTAGCTT
TGTCAATGTAG->GTCAATGTAGA
TGTCACCCGGA->GTCACCCGGAC
TGTCGATGAGG->GTCGATGAGGG
TGTCGGACTAA->GTCGGACTAAA
TGTCGGCCCCT->GTCGGCCCCTA
TGTCGTAAGAC->GTCGTAAGACA
TGTCTTGCAAG->GTCTTGCAAGG
TGTGAAAAGCA->GTGAAAAGCAG
TGTGACAACTC->GTGACAACTCG
TGTGCACGATA->GTGCACGATAG
TGTGCGAGCAC->GTGCGAGCACT
TGTTACCCTTG->GTTACCCTTGA
TGTTAGATTAA->GTTAGATTAAG
TGTTCGCGAGA->GTTCGCGAGAA
TGTTCTGAGCG->GTTCTGAGCGT
TGTTGCCCTAT->GTTGCCCTATT
TGTTTACGCTA->GTTTACGCTAT
TGTTTCTCTGA->GTTTCTCTGAT
TGTTTGTCACC->GTTTGTCACCC
TGTTTTATCAA->GTTTTATCAAA
TGTTTTGAGGC->GTTTTGAGGCG
TGTTTTGGTAA->GTTTTGGTAAG
TTAAAGAGCAC->TAAAGAGCACC
TTAACAAGAGT->TAACAAGAGTC
TTAACATAGCG->TAACATAGCGA
TTAAGAGAAGG->TAAGAGAAGGA
TTAAGATCGAT->TAAGATCGATG
TTAAGTTTAGC->TAAGTTTAGCA
TTAATTGTCGA->TAATTGTCGAT
TTACATTCCAT->TACATTCCATA
TTACCATAAAT->TACCATAAATA
TTACCCTTGAA->TACCCTTGAAT
TTACGCTATTC->TACGCTATTCC
TTACGGCTAAG->TACGGCTAAGT
TTACGTCCGCC->TACGTCCGCCC
TTACGTTCTTT->TACGTTCTTTC
TTACTACTTCA->TACTACTTCAG
TTACTGCATAT->TACTGCATATC
TTACTTTGTAC->TACTTTGTACA
TTAGAGTGCTC->TAGAGTGCTCA
TTAGATTAAGT->TAGATTAAGTT
TTAGCACGCCG->TAGCACGCCGG
TTAGCCGGTAT->TAGCCGGTATT
TTAGCGAGACA->TAGCGAGACAA
TTAGCGCACCG->TAGCGCACCGA
TTAGCTTCCCG->TAGCTTCCCGT
TTAGGAAGCAC->TAGGAAGCACC
TTAGGATTTAG->TAGGATTTAGG
TTAGGTAGGGC->TAGGTAGGGCT
TTAGGTGGATC->TAGGTGGATCG
TTATCAAATCT->TATCAAATCTT
TTATCAGACGC->TATCAGACGCT
TTATCCAAGGG->TATCCAAGGGG
TTCAATAAGAA->TCAATAAGAAA
TTCACACCAGG->TCACACCAGGA
TTCACCACATG->TCACCACATGC
TTCACGACTGA->TCACGACTGAT
TTCAGAAAATA->TCAGAAAATAT
TTCAGCTAAGT->TCAGCTAAGTA
TTCATAGGCCC->TCATAGGCCCC
TTCCACGATGG->TCCACGATGGA
TTCCAGAGCGA->TCCAGAGCGAC
TTCCATAGCTA->TCCATAGCTAT
TTCCCGTCAAC->TCCCGTCAACT
TTCCGACGTTA->TCCGACGTTAG
TTCCGCCGGCA->TCCGCCGGCAG
TTCCGCTTGAA->TCCGCTTGAAG
TTCCGTATTAG->TCCGTATTAGG
TTCCGTTAGGA->TCCGTTAGGAA
TTCCTATGATT->TCCTATGATTG
TTCCTCCGGAA->TCCTCCGGAAC
TTCCTCGCACC->TCCTCGCACCG
TTCGACTATAG->TCGACTATAGA
TTCGCGAGAAG->TCGCGAGAAGG
TTCGGACGCAA->TCGGACGCAAT
TTCGGATGCTA->TCGGATGCTAT
TTCGGCGCCGC->TCGGCGCCGCT
TTCGTCCTTAG->TCGTCCTTAGA
TTCTCAGCAAT->TCTCAGCAATT
TTCTCTGATAA->TCTCTGATAAC
TTCTGAGCGTG->TCTGAGCGTGG
TTCTGGAATTG->TCTGGAATTGG
TTCTTACGTCC->TCTTACGTCCG
TTCTTTCACAC->TCTTTCACACC
TTCTTTCTTAC->TCTTTCTTACG
TTGAAACTAGA->TGAAACTAGAG
TTGAAGCACAA->TGAAGCACAAT
TTGAAGCACTT->TGAAGCACTTA
TTGAATTCGTC->TGAATTCGTCC
TTGACTAGAGC->TGACTAGAGCG
TTGAGGCGTGG->TGAGGCGTGGA
TTGAGTGACAA->TGAGTGACAAC
TTGATACTGAT->TGATACTGATC
TTGATCATGCC->TGATCATGCCT
TTGATTTCACG->TGATTTCACGA
TTGCAAGACAT->TGCAAGACATT
TTGCAAGGAAT->TGCAAGGAATT
TTGCACGGTCG->TGCACGGTCGC
TTGCAGTCATG->TGCAGTCATGG
TTGCAGTCCTC->TGCAGTCCTCG
TTGCCCTACGG->TGCCCTACGGG
TTGCCCTATTT->TGCCCTATTTC
TTGCTCGGCTA->TGCTCGGCTAG
TTGCTGCCGTC->TGCTGCCGTCC
TTGCTTCACCA->TGCTTCACCAC
TTGGACAACTG->TGGACAACTGT
TTGGACTGCGC->TGGACTGCGCT
TTGGCCATAAA->TGGCCATAAAA
TTGGCGAAGGT->TGGCGAAGGTG
TTGGCGAGCGA->TGGCGAGCGAG
TTGGGCCCATA->TGGGCCCATAT
TTGGGCCCTAG->TGGGCCCTAGA
TTGGGGAGTTG->TGGGGAGTTGG
TTGGGTTTACC->TGGGTTTACCA
TTGGTAAGTCG->TGGTAAGTCGT
TTGGTCGTTGG->TGGTCGTTGGA
TTGTACATTCG->TGTACATTCGA
TTGTCAATGTA->TGTCAATGTAG
TTGTCACCCGG->TGTCACCCGGA
TTGTCGATGAG->TGTCGATGAGG
TTGTGACAACT->TGTGACAACTC
TTTAAGATCGA->TTAAGATCGAT
TTTACCATAAA->TTACCATAAAT
TTTACGCTATT->TTACGCTATTC
TTTACGGCTAA->TTACGGCTAAG
TTTAGCACGCC->TTAGCACGCCG
TTTAGCGAGAC->TTAGCGAGACA
TTTAGGTAGGG->TTAGGTAGGGC
TTTATCAAATC->TTATCAAATCT
TTTCACACCAG->TTCACACCAGG
TTTCACGACTG->TTCACGACTGA
TTTCAGCTAAG->TTCAGCTAAGT
TTTCCAGAGCG->TTCCAGAGCGA
TTTCCGCCGGC->TTCCGCCGGCA
TTTCCGTATTA->TTCCGTATTAG
TTTCGGATGCT->TTCGGATGCTA
TTTCTCTGATA->TTCTCTGATAA
TTTCTGGAATT->TTCTGGAATTG
TTTCTTACGTC->TTCTTACGTCC
TTTCTTTCACA->TTCTTTCACAC
TTTGACTAGAG->TTGACTAGAGC
TTTGAGGCGTG->TTGAGGCGTGG
TTTGATACTGA->TTGATACTGAT
TTTGATCATGC->TTGATCATGCC
TTTGCAAGACA->TTGCAAGACAT
TTTGCACGGTC->TTGCACGGTCG
TTTGGACAACT->TTGGACAACTG
TTTGGGTTTAC->TTGGGTTTACC
TTTGGTAAGTC->TTGGTAAGTCG
TTTGTACATTC->TTGTACATTCG
TTTGTCACCCG->TTGTCACCCGG
TTTTATCAAAT->TTTATCAAATC
TTTTCCAGAGC->TTTCCAGAGCG
TTTTGAGGCGT->TTTGAGGCGTG
TTTTGGTAAGT->TTTGGTAAGTC
TTTTTCCAGAG->TTTTCCAGAGC